# From bin/get_pathway_compounds.pl on Sun Jul 26 11:16:24 2020
# Pathway	Compounds
SALVADEHYPOX-PWY	RIBOSE-1P,INOSINE,AMMONIUM,URATE,PROTON,NADH,XANTHINE,HYPOXANTHINE,NAD,|Pi|,ADENOSINE,AMP,WATER
METHGLYUT-PWY	E-,GLUTATHIONE,S-LACTOYL-GLUTATHIONE,|Ubiquinols|,|Ubiquinones|,D-LACTATE,ACETOL,PROPANE-1-2-DIOL,NADH,WATER,NAD,PYRUVATE,|ETR-Quinols|,|ETR-Quinones|,L-LACTATE,PROTON,NADPH,METHYL-GLYOXAL,LACTALD,NADP
PWY0-1499	PHOSPHO-DPIA,G6346-MONOMER,PHOSPHO-DPIB,ADP,ATP,G6345-MONOMER
PWY0-1559	ADP,ATP,EG12007-MONOMER,MONOMER0-4276,EG12006-MONOMER,MONOMER0-4457
GLUAMCAT-PWY	FRUCTOSE-6P,AMMONIUM,CPD-13469,ACET,D-GLUCOSAMINE-6-P,N-ACETYL-D-GLUCOSAMINE-6-P,WATER
PWY0-1470	ADP,ATP,EG12658-MONOMER,MONOMER0-2741,G7575-MONOMER,MONOMER0-4171
PWY0-662	AMP,PRPP,PROTON,RIBOSE-5P,ATP
PWY0-1503	MONOMER0-4147,EG11285-MONOMER,ADP,MONOMER0-4141,ATP,CPLX0-8275
ECASYN-PWY	UDP,TDP,C55-PP-GLCNAC-MANNACA,UMP,ACETYL-D-GLUCOSAMINYLDIPHOSPHO-UNDECAPRE,CPD-9646,CO-A,TDP-FUC4NAC,ACETYL-COA,GLT,TDP-D-FUCOSAMINE,2-KETOGLUTARATE,PPI,GLC-1-P,TTP,DTDP-DEOH-DEOXY-GLUCOSE,DTDP-D-GLUCOSE,PROTON,NADH,UDP-MANNACA,NAD,WATER,UDP-MANNAC,UDP-N-ACETYL-D-GLUCOSAMINE,C55-PP-GLCNAC-MANNACA-FUC4NAC
KDOSYN-PWY	LIPID-IV-A,CMP,KDO2-LIPID-IVA,PROTON,KDO-LIPID-IVA,CMP-KDO
PWY0-1482	PHOSPHO-BASR,BASR-MONOMER,PHOSPHO-BASS,ADP,ATP,BASS-MONOMER
PWY0-1509	PROTEIN-NRIP,GLNG-CPLX,ADP,PROTEIN-NRIIP,GLNL-CPLX,ATP
OANTIGEN-PWY	|Phosphorylated-Phosphoglucosamine-Mutase|,CPD0-1096,|Phosphoglucosamine-Mutase|,UDP-D-GALACTO-14-FURANOSE,CPD-14553,DTDP-DEOH-DEOXY-MANNOSE,NADPH,NADP,DTDP-RHAMNOSE,DTDP-DEOH-DEOXY-GLUCOSE,WATER,DTDP-D-GLUCOSE,GLC-1-P,TTP,PPI,UDP-N-ACETYL-D-GLUCOSAMINE,UTP,CO-A,N-ACETYL-D-GLUCOSAMINE-1-P,PROTON,ACETYL-COA,GLT,GLN,GLUCOSAMINE-1P,D-GLUCOSAMINE-6-P,FRUCTOSE-6P,|D-glucopyranose-6-phosphate|
GALACTMETAB-PWY	ADP,ATP,GALACTOSE-1P,CPD-14553,PPI,CPD-12575,PROTON,GLC-1-P,UTP,ALPHA-D-GALACTOSE,GALACTOSE
PWY0-1487	PHOSPHO-CREB,CREB-MONOMER,PHOSPHO-CREC,ADP,ATP,CREC-MONOMER
PWY0-1241	ADP,PPI,PROTON,ATP,|Pi|,D-BETA-D-HEPTOSE-1-P,D-BETA-D-HEPTOSE-17-DIPHOSPHATE,WATER,ADP-L-GLYCERO-D-MANNO-HEPTOSE,ADP-D-GLYCERO-D-MANNO-HEPTOSE,D-ALPHABETA-D-HEPTOSE-7-PHOSPHATE,D-SEDOHEPTULOSE-7-P
PWY0-1515	PHOSPHO-NARP,NARP-MONOMER,ADP,ATP,NARX-CPLX,PHOSPHO-NARL,PHOSPHO-NARX,NARL-MONOMER
PWY0-1280	GLYCOLLATE,WATER,NADH,GLYCOLALDEHYDE,PROTON,NAD,GLYCOL
PWY0-1493	MONOMER0-4194,PHOSPHO-RCSC,ADP,ATP,RCSC-MONOMER,PHOSPHO-RCSB,EG12385-MONOMER,RCSB-MONOMER,MONOMER0-4189
GLYCOL-GLYOXDEG-PWY	CARBON-DIOXIDE,|Donor-H2|,|Acceptor|,TARTRONATE-S-ALD,ADP,2-PG,ATP,GLYCERATE,CO-A,MAL,ACETYL-COA,GLYOX,GLYCOLLATE,WATER,NADH,GLYCOLALDEHYDE,PROTON,NAD,GLYCOL
PWY0-1498	PHOSPHO-HYDG,HYDG-MONOMER,PROTON,ADP,PHOSPHO-HYDH,HYDH-MONOMER,ATP
GLYCEROLMETAB-PWY	PROTON,NADH,GLYCEROL,NAD,PYRUVATE,DIHYDROXY-ACETONE-PHOSPHATE,DIHYDROXYACETONE,PHOSPHO-ENOL-PYRUVATE
PWY0-381	E-,ADP,GLYCEROL,ATP,|Ubiquinols|,|Ubiquinones|,DIHYDROXY-ACETONE-PHOSPHATE,|Menaquinols|,|Menaquinones|,PROTON,GLYCEROL-3P,|Alcohols|,|Glycerophosphodiesters|,WATER
OXIDATIVEPENT-PWY	WATER,PROTON,D-6-P-GLUCONO-DELTA-LACTONE,|D-glucopyranose-6-phosphate|,NADPH,CARBON-DIOXIDE,RIBULOSE-5P,CPD-2961,NADP
PROSYN-PWY	WATER,L-DELTA1-PYRROLINE_5-CARBOXYLATE,NADH-P-OR-NOP,NAD-P-OR-NOP,PRO,PROTON,NADPH,L-GLUTAMATE_GAMMA-SEMIALDEHYDE,|Pi|,NADP,ADP,L-GLUTAMATE-5-P,GLT,ATP
NONOXIPENT-PWY	FRUCTOSE-6P,ERYTHROSE-4P,D-SEDOHEPTULOSE-7-P,GAP,XYLULOSE-5-PHOSPHATE,RIBULOSE-5P,RIBOSE-5P
PWY0-1550	ADP,ATP,MONOMER0-4288,G7243-MONOMER,MONOMER0-4287,G7244-MONOMER
PENTOSE-P-PWY	FRUCTOSE-6P,ERYTHROSE-4P,D-SEDOHEPTULOSE-7-P,GAP,XYLULOSE-5-PHOSPHATE,RIBOSE-5P,WATER,PROTON,D-6-P-GLUCONO-DELTA-LACTONE,|D-glucopyranose-6-phosphate|,NADPH,CARBON-DIOXIDE,RIBULOSE-5P,CPD-2961,NADP
PWY0-1546	D-ALANINE,CPD0-1082,MESO-DIAMINOPIMELATE,L-ALA-GAMMA-D-GLU-DAP,CPD0-2190,GLT,L-ALPHA-ALANINE,CPD0-1445,WATER
PWY0-521	LYS,GLC-6-P,WATER,ADP,FRUCTOSELYSINE-6-PHOSPHATE,PROTON,ATP,PSICOSELYSINE,FRUCTOSELYSINE
HCAMHPDEG-PWY	SUC,CPD-14447,CPD-157,WATER,3-HYDROXYPHENYL-PROPIONATE,2-3-DIHYDROXYPHENYL-PROPIONATE,NAD,CARBOXYETHYL-3-5-CYCLOHEXADIENE-1-2-DIOL,3-PHENYLPROPIONATE,NADH,OXYGEN-MOLECULE,PROTON
PWY-6952	E-,PROTON,|Alcohols|,|Glycerophosphodiesters|,WATER,|Ubiquinols|,|Ubiquinones|,DIHYDROXY-ACETONE-PHOSPHATE,|Menaquinols|,|Menaquinones|,GLYCEROL-3P
PWY-6690	CPD-674,FUM,CPD-14447,CPD0-2184,CPD-13034,NAD,WATER,CPD-10796,CPD-10797,OXYGEN-MOLECULE,NADH,PROTON
PWY-5509	GMP,ADENOSYLCOBINAMIDE-GDP,|Pi|,ADENOSYLCOBALAMIN,ADENOSYLCOBALAMIN-5-P,WATER,ALPHA-RIBAZOLE-5-P,NIACINE,PROTON,NICOTINATE_NUCLEOTIDE,DIMETHYLBENZIMIDAZOLE
ENTNER-DOUDOROFF-PWY	PYRUVATE,GAP,WATER,2-KETO-3-DEOXY-6-P-GLUCONATE,CPD-2961
2PHENDEG-PWY	HYDROGEN-PEROXIDE,AMMONIUM,OXYGEN-MOLECULE,PHENYLETHYLAMINE,PHENYLACETATE,NADH,PROTON,WATER,NAD,PHENYLACETALDEHYDE
PWY0-1261	|Phosphorylated-Phosphoglucosamine-Mutase|,CPD0-1096,|Phosphoglucosamine-Mutase|,D-LACTATE,CPD0-881,CPD0-882,N-ACETYL-D-GLUCOSAMINE,CPD0-1081,CPD0-1080,ACET,N-ACETYL-D-GLUCOSAMINE-6-P,D-GLUCOSAMINE-6-P,CO-A,GLUCOSAMINE-1P,ACETYL-COA,PPI,N-ACETYL-D-GLUCOSAMINE-1-P,UTP,D-ALANINE,CPD0-1082,WATER,ADP,UDP-AAGM-DIAMINOHEPTANEDIOATE,L-ALA-GAMMA-D-GLU-DAP,ATP,|Pi|,UDP-N-ACETYL-D-GLUCOSAMINE,PHOSPHO-ENOL-PYRUVATE,UDP-ACETYL-CARBOXYVINYL-GLUCOSAMINE,NADPH,PROTON,NADP,UDP-N-ACETYLMURAMATE
ILEUSYN-PWY	GLT,2-KETO-3-METHYL-VALERATE,ILE,2-KETOGLUTARATE,NADPH,1-KETO-2-METHYLVALERATE,NADP,CARBON-DIOXIDE,2-ACETO-2-HYDROXY-BUTYRATE,PYRUVATE,THR,AMMONIUM,2-OXOBUTANOATE,PROTON,WATER,CPD-16013,CPD-15056
BGALACT-PWY	|Glucopyranose|,GALACTOSE,CPD-15972,WATER
PWY0-1534	GLT,2-KETOGLUTARATE,CYS,HS,PYRUVATE,3-MERCAPTO-PYRUVATE
PWY0-522	AMP,|Lipoyl-Protein-N6-lipoyllysine|,|Lipoyl-Protein-L-Lysine|,PPI,LIPOYL-AMP,PROTON,LIPOIC-ACID,ATP
PWY0-501	|Oxidized-ferredoxins|,FE+2,CPD-7046,|Iron-Sulfur-Cluster-Scaffold-Proteins|,MET,CH33ADO,|Dihydro-Lipoyl-Proteins|,S-ADENOSYLMETHIONINE,|Fe4S4-Cluster-Protein|,|Reduced-ferredoxins|,PROTON,ACP,|Octanoylated-domains|,|Octanoyl-ACPs|,|Lipoyl-Protein-L-Lysine|
PWY0-1275	PPI,AMP,|Lipoyl-Protein-L-Lysine|,CPD-195,ATP,|Oxidized-ferredoxins|,FE+2,CPD-7046,|Iron-Sulfur-Cluster-Scaffold-Proteins|,MET,CH33ADO,|Dihydro-Lipoyl-Proteins|,S-ADENOSYLMETHIONINE,|Octanoylated-domains|,|Fe4S4-Cluster-Protein|,PROTON,|Reduced-ferredoxins|
PWY0-1338	NADH,CARBON-DIOXIDE,UDP-GLUCURONATE,NAD,PROTON,THF-GLU-N,FORMYL-THF-GLU-N,GLT,5-BETA-L-THREO-PENTAPYRANOSYL-4-ULOSE-,UDP-4-AMINO-4-DEOXY-L-ARABINOSE,2-KETOGLUTARATE,UDP,UDP-L-ARA4-FORMYL-N,FORMATE,CPD0-888,WATER,CPD-9646,L-ARA4N-MODIFIED-KDO2-LIPID-A,KDO2-LIPID-A,CPD0-1189
PWY-5194	NADH,NAD,SIROHEME,SIROHYDROCHLORIN,FE+2,PROTON,UROPORPHYRINOGEN-III,DIHYDROSIROHYDROCHLORIN,ADENOSYL-HOMO-CYS,S-ADENOSYLMETHIONINE,CPD-9038
PWY-6163	CHORISMATE,|Pi|,3-ENOLPYRUVYL-SHIKIMATE-5P,PHOSPHO-ENOL-PYRUVATE,ADP,SHIKIMATE-5P,ATP,NADPH,PROTON,NADP,SHIKIMATE,3-DEHYDRO-SHIKIMATE,WATER,DEHYDROQUINATE
ARO-PWY	3-DEOXY-D-ARABINO-HEPTULOSONATE-7-P,ERYTHROSE-4P,CHORISMATE,|Pi|,3-ENOLPYRUVYL-SHIKIMATE-5P,PHOSPHO-ENOL-PYRUVATE,ADP,SHIKIMATE-5P,ATP,NADPH,PROTON,NADP,SHIKIMATE,3-DEHYDRO-SHIKIMATE,WATER,DEHYDROQUINATE
GLYCOLYSIS-TCA-GLYOX-BYPASS	|Oxo-glutarate-dehydrogenase-lipoyl|,|Oxo-glutarate-dehydro-suc-DH-lipoyl|,|Oxo-glutarate-dehydrogenase-DH-lipoyl|,OXALO-SUCCINATE,E-,23-DIPHOSPHOGLYCERATE,|Protein-Histidines|,|Protein-pi-phospho-L-histidines|,CPD-16758,|Pyruvate-dehydrogenase-lipoate|,|Pyruvate-dehydrogenase-acetylDHlipoyl|,|Pyruvate-dehydrogenase-dihydrolipoate|,2-ALPHA-HYDROXYETHYL-THPP,THIAMINE-PYROPHOSPHATE,GLYOX,CIS-ACONITATE,CIT,SUC-COA,2-KETOGLUTARATE,NADPH,THREO-DS-ISO-CITRATE,NADP,FUM,|Ubiquinols|,|Ubiquinones|,SUC,OXALACETIC_ACID,|ETR-Quinols|,|ETR-Quinones|,MAL,DPG,GAP,DIHYDROXY-ACETONE-PHOSPHATE,ADP,|D-glucopyranose-6-phosphate|,AMP,PHOSPHO-ENOL-PYRUVATE,PROTON,ATP,|Pi|,FRUCTOSE-6P,FRUCTOSE-16-DIPHOSPHATE,WATER,G3P,2-PG,NADH,CARBON-DIOXIDE,ACETYL-COA,PYRUVATE,CO-A,NAD
PWY-6519	METOH,|Pimeloyl-ACP-methyl-esters|,|Enoylpimeloyl-ACP-methyl-esters|,|3-hydroxypimeloyl-ACP-methyl-esters|,|3-Ketopimeloyl-ACP-methyl-esters|,NADH,|Glutaryl-ACP-methyl-esters|,NAD,WATER,|Enoylglutaryl-ACP-methyl-esters|,NADPH,|3-Hydroxyglutaryl-ACP-methyl-ester|,NADP,ADENOSYL-HOMO-CYS,S-ADENOSYLMETHIONINE,|3-Ketoglutaryl-ACP-methyl-ester|,|Malonyl-acp-methyl-ester|,MALONYL-ACP,ACP,CARBON-DIOXIDE,8-AMINO-7-OXONONANOATE,|Pimeloyl-ACPs|,L-ALPHA-ALANINE,PROTON
GLYCOLYSIS-E-D	23-DIPHOSPHOGLYCERATE,|Protein-Histidines|,|Protein-pi-phospho-L-histidines|,CPD-16758,2-KETO-3-DEOXY-6-P-GLUCONATE,NADH,DPG,NAD,GAP,DIHYDROXY-ACETONE-PHOSPHATE,ADP,AMP,PHOSPHO-ENOL-PYRUVATE,PYRUVATE,ATP,|Pi|,FRUCTOSE-6P,FRUCTOSE-16-DIPHOSPHATE,G3P,2-PG,NADPH,|D-glucopyranose-6-phosphate|,NADP,CPD-2961,PROTON,D-6-P-GLUCONO-DELTA-LACTONE,WATER
TREDEGLOW-PWY	TREHALOSE-6P,WATER,PROTON,ADP,|D-glucopyranose-6-phosphate|,|Glucopyranose|,ATP
PWY0-1517	ADP,PROTON,D-SEDOHEPTULOSE-7-P,ATP,D-SEDOHEPTULOSE-1-7-P2,DIHYDROXY-ACETONE-PHOSPHATE,ERYTHROSE-4P
GLYOXYLATE-BYPASS	NADH,NAD,MAL,SUC,GLYOX,THREO-DS-ISO-CITRATE,CO-A,PROTON,OXALACETIC_ACID,ACETYL-COA,WATER,CIS-ACONITATE,CIT
PWY0-1466	TREHALOSE,WATER,GLC,ALPHA-GLUCOSE
PWY0-1182	ALPHA-GLUCOSE,GLC,TREHALOSE,WATER,PROTON,ADP,|D-glucopyranose-6-phosphate|,|Glucopyranose|,ATP
PWY-5755	PYRUVATE,|4-hydroxybenzoate|,CHORISMATE
ALANINE-VALINESYN-PWY	GLT,2-KETOGLUTARATE,D-ALANINE,2-KETO-ISOVALERATE,L-ALPHA-ALANINE,PYRUVATE,VAL
ALANINE-SYN2-PWY	PYRUVATE,GLT,2-KETOGLUTARATE,L-ALPHA-ALANINE
PWY0-1061	D-ALANINE,2-KETO-ISOVALERATE,VAL,|L-Cysteine-Desulfurase-persulfide|,|Cysteine-Desulfurase-L-cysteine|,CYS,PYRUVATE,GLT,2-KETOGLUTARATE,L-ALPHA-ALANINE
PWY0-1021	L-ALPHA-ALANINE,|L-Cysteine-Desulfurase-persulfide|,|Cysteine-Desulfurase-L-cysteine|,CYS
FERMENTATION-PWY	|Oxidized-hydrogenase-3|,|Reduced-hydrogenase-3|,E-,OXALO-SUCCINATE,ACETYL-P,ACET,ACETALD,ETOH,ADP,ATP,PYRUVATE,D-LACTATE,NADH,MAL,NAD,HCO3,PHOSPHO-ENOL-PYRUVATE,|Pi|,HYDROGEN-MOLECULE,FORMATE,SUC,|Menaquinones|,|Menaquinols|,FUM,CO-A,PROTON,OXALACETIC_ACID,ACETYL-COA,CIT,CIS-ACONITATE,WATER,CARBON-DIOXIDE,2-KETOGLUTARATE,NADPH,THREO-DS-ISO-CITRATE,NADP
PWY0-1312	ADP,ACET,ATP,CO-A,ACETYL-P,|Pi|,ACETYL-COA
PWY-4261	E-,ADP,PROTON,GLYCEROL,ATP,|Ubiquinols|,|Ubiquinones|,DIHYDROXY-ACETONE-PHOSPHATE,|Menaquinols|,|Menaquinones|,GLYCEROL-3P
PWY-5686	AMMONIUM,CARBAMATE,CPD-18238,E-,ADP,GLT,ATP,GLN,HCO3,|Pi|,L-ASPARTATE,CARBAMOYL-P,CARBAMYUL-L-ASPARTATE,WATER,PRPP,PPI,UMP,CARBON-DIOXIDE,PROTON,OROTIDINE-5-PHOSPHATE,OROTATE,|ETR-Quinols|,|ETR-Quinones|,DI-H-OROTATE
ACETOACETATE-DEG-PWY	PROT-CYS,|Protein-S-Acetyl-Cysteines|,CO-A,ACET,ACETOACETYL-COA,3-KETOBUTYRATE,ACETYL-COA
PWY0-1545	PROTON,CMP,CDPDIACYLGLYCEROL,GLYCEROL-3P,|Pi|,L-1-PHOSPHATIDYL-GLYCEROL-P,WATER,ETHANOL-AMINE,CARDIOLIPIN,L-1-PHOSPHATIDYL-GLYCEROL,L-1-PHOSPHATIDYL-ETHANOLAMINE
PWY-6537	GLT,2-KETOGLUTARATE,4-AMINO-BUTYRATE,PROTON,NADPH,SUC,SUCC-S-ALD,NADP,WATER
PWY-5668	|Pi|,WATER,GLYCEROL,CARDIOLIPIN,L-1-PHOSPHATIDYL-GLYCEROL,PROTON,L-1-PHOSPHATIDYL-GLYCEROL-P,CMP,CDPDIACYLGLYCEROL,GLYCEROL-3P
PWY-6535	GLT,2-KETOGLUTARATE,4-AMINO-BUTYRATE,SUC,NADH,PROTON,WATER,NAD,SUCC-S-ALD
TRYPDEG-PWY	AMMONIUM,PYRUVATE,CPD-16015,WATER,2-AMINOACRYLATE,INDOLE,TRP
4AMINOBUTMETAB-PWY	GLT,2-KETOGLUTARATE,4-AMINO-BUTYRATE,NADH,NAD,PROTON,NADPH,SUC,SUCC-S-ALD,NADP,WATER
ALADEG-PWY	E-,PROTON,L-ALPHA-ALANINE,PYRUVATE,AMMONIUM,|ETR-Quinols|,|ETR-Quinones|,WATER,D-ALANINE
TCA	|Oxo-glutarate-dehydrogenase-lipoyl|,|Oxo-glutarate-dehydro-suc-DH-lipoyl|,|Oxo-glutarate-dehydrogenase-DH-lipoyl|,OXALO-SUCCINATE,E-,|Pi|,ADP,ATP,NADH,SUC-COA,NAD,CARBON-DIOXIDE,2-KETOGLUTARATE,NADPH,NADP,THREO-DS-ISO-CITRATE,CO-A,PROTON,ACETYL-COA,WATER,CIS-ACONITATE,CIT,FUM,|Ubiquinols|,|Ubiquinones|,SUC,OXALACETIC_ACID,|ETR-Quinols|,|ETR-Quinones|,MAL
PWY-6910	PROTON,HMP,ADP,AMINO-HYDROXYMETHYL-METHYLPYRIMIDINE-PP,AMINO-HYDROXYMETHYL-METHYL-PYR-P,ATP
PWY0-1277	SUC,CPD-157,3-HYDROXYPHENYL-PROPIONATE,2-3-DIHYDROXYPHENYL-PROPIONATE,CARBOXYETHYL-3-5-CYCLOHEXADIENE-1-2-DIOL,3-PHENYLPROPIONATE,OXYGEN-MOLECULE,WATER,CPD-14447,PYRUVATE,4-HYDROXY-2-KETOVALERATE,ACETYL-COA,NADH,PROTON,NAD,CO-A,ACETALD
LIPA-CORESYN-PWY	KDO2-LIPID-A,CPD0-929,CPD0-930,CPD0-932,CPD0-933,CPD0-934,ATP,CPD-14553,CPD0-935,CPD0-936,CPD-12575,CPD0-937,ADP,CPD0-938,ADP-L-GLYCERO-D-MANNO-HEPTOSE,PROTON,UDP,CPD0-939,UDP-N-ACETYL-D-GLUCOSAMINE,CPD-21359
PWY-6122	PRPP,PPI,5-P-BETA-D-RIBOSYL-AMINE,GLY,GLT,GLN,WATER,5-PHOSPHORIBOSYL-5-AMINOIMIDAZOLE,5-PHOSPHORIBOSYL-N-FORMYLGLYCINEAMIDINE,ADP,5-P-RIBOSYL-N-FORMYLGLYCINEAMIDE,|Pi|,PROTON,5-PHOSPHO-RIBOSYL-GLYCINEAMIDE,FORMATE,ATP
PWY0-1264	AMP,PPI,|BCCP-L-lysine|,BIOTIN,|BCCP-biotin-L-lysine|,PROTON,ADP,|Pi|,HCO3,ATP,|biotin-L-lysine-in-BCCP-dimers|,MALONYL-COA,ACETYL-COA,|carboxybiotin-L-lysine-in-BCCP-dimers|
PWY-7315	CO-A,TDP-FUC4NAC,ACETYL-COA,GLT,TDP-D-FUCOSAMINE,2-KETOGLUTARATE,PPI,PROTON,GLC-1-P,TTP,DTDP-DEOH-DEOXY-GLUCOSE,WATER,DTDP-D-GLUCOSE
KDO-NAGLIPASYN-PWY	CMP,KDO-LIPID-IVA,UDP,ADP,LIPID-IV-A,BISOHMYR-GLC,ATP,UMP,BISOHMYR-GLUCOSAMINYL-1P,PROTON,OH-MYRISTOYL,ACET,UDP-OHMYR-GLUCOSAMINE,UDP-OHMYR-ACETYLGLUCOSAMINE,|R-3-hydroxymyristoyl-ACPs|,UDP-N-ACETYL-D-GLUCOSAMINE,|Dodecanoyl-ACPs|,KDO2-LIPID-A,KDO2-LAUROYL-LIPID-IVA,|Palmitoleoyl-ACPs|,KDO2-LIPID-IVA,ACP,KDO2-LIPID-IVA-COLD,|Myristoyl-ACPs|,KDO2-PALMITOLEOYL-LIPID-IVA,PPI,CMP-KDO,CTP,KDO,|Pi|,KDO-8P,WATER,PHOSPHO-ENOL-PYRUVATE,RIBULOSE-5P,CPD-18118,ARABINOSE-5P
PWY-6277	PRPP,PPI,5-P-BETA-D-RIBOSYL-AMINE,GLY,GLT,GLN,WATER,5-PHOSPHORIBOSYL-5-AMINOIMIDAZOLE,5-PHOSPHORIBOSYL-N-FORMYLGLYCINEAMIDINE,ADP,|Pi|,FORMATE,ATP,PROTON,5-P-RIBOSYL-N-FORMYLGLYCINEAMIDE,THF-GLU-N,FORMYL-THF-GLU-N,5-PHOSPHO-RIBOSYL-GLYCINEAMIDE
NAGLIPASYN-PWY	UDP,ADP,LIPID-IV-A,BISOHMYR-GLC,ATP,UMP,BISOHMYR-GLUCOSAMINYL-1P,PROTON,OH-MYRISTOYL,ACET,UDP-OHMYR-GLUCOSAMINE,WATER,ACP,UDP-OHMYR-ACETYLGLUCOSAMINE,|R-3-hydroxymyristoyl-ACPs|,UDP-N-ACETYL-D-GLUCOSAMINE
DTDPRHAMSYN-PWY	DTDP-DEOH-DEOXY-MANNOSE,NADPH,NADP,DTDP-RHAMNOSE,DTDP-DEOH-DEOXY-GLUCOSE,WATER,PPI,DTDP-D-GLUCOSE,PROTON,GLC-1-P,TTP
KDO-LIPASYN-PWY	|Dodecanoyl-ACPs|,KDO2-LIPID-IVA,ACP,KDO2-LIPID-A,|Myristoyl-ACPs|,KDO2-LAUROYL-LIPID-IVA
PWY-6121	PRPP,PPI,5-P-BETA-D-RIBOSYL-AMINE,GLY,THF-GLU-N,FORMYL-THF-GLU-N,5-PHOSPHO-RIBOSYL-GLYCINEAMIDE,GLT,5-P-RIBOSYL-N-FORMYLGLYCINEAMIDE,GLN,WATER,5-PHOSPHORIBOSYL-5-AMINOIMIDAZOLE,|Pi|,ADP,PROTON,ATP,5-PHOSPHORIBOSYL-N-FORMYLGLYCINEAMIDINE
LPSSYN-PWY	BISOHMYR-GLC,UMP,BISOHMYR-GLUCOSAMINYL-1P,OH-MYRISTOYL,ACET,UDP-OHMYR-GLUCOSAMINE,UDP-OHMYR-ACETYLGLUCOSAMINE,|R-3-hydroxymyristoyl-ACPs|,PPI,CTP,KDO,|Pi|,KDO-8P,WATER,PHOSPHO-ENOL-PYRUVATE,RIBULOSE-5P,CPD-18118,ARABINOSE-5P,LIPID-IV-A,CMP,KDO-LIPID-IVA,CMP-KDO,|Dodecanoyl-ACPs|,KDO2-LIPID-IVA,ACP,|Myristoyl-ACPs|,KDO2-LAUROYL-LIPID-IVA,KDO2-LIPID-A,CPD0-929,CPD0-930,CPD0-932,CPD0-933,CPD0-934,ATP,CPD-14553,CPD0-935,CPD0-936,CPD-12575,CPD0-937,ADP,CPD0-938,ADP-L-GLYCERO-D-MANNO-HEPTOSE,PROTON,UDP,CPD0-939,UDP-N-ACETYL-D-GLUCOSAMINE,CPD-21359
PWY-7544	E-,ACET,CARBON-DIOXIDE,PYRUVATE,PROTON,|Ubiquinones|,WATER,OXYGEN-MOLECULE,|Ubiquinols|
PWY0-1334	E-,NAD,NADH,PROTON,|Ubiquinones|,WATER,OXYGEN-MOLECULE,|Ubiquinols|
TYRSYN	GLT,TYR,2-KETOGLUTARATE,NADH,CARBON-DIOXIDE,P-HYDROXY-PHENYLPYRUVATE,NAD,PREPHENATE,CHORISMATE
PWY0-1544	E-,WATER,OXYGEN-MOLECULE,L-DELTA1-PYRROLINE_5-CARBOXYLATE,PROTON,|Ubiquinols|,|Ubiquinones|,PRO
PWY0-1567	E-,NAD,NADH,PROTON,|Ubiquinones|,WATER,OXYGEN-MOLECULE,|Ubiquinols|
PWY0-1329	E-,PROTON,WATER,OXYGEN-MOLECULE,FUM,|Ubiquinols|,|Ubiquinones|,SUC
PWY-7805	CO-A,CPD0-1074,ACETYL-COA,CPD0-2518,CPD-19235,|Acceptor|,MET,CH33ADO,CPD-19237,S-ADENOSYLMETHIONINE,CPD-19236,|Donor-H2|,CPD0-2463,ADP,RIBOSE-15-BISPHOSPHATE,ATP,ADENINE,PRPP,AMP,|Pi|,PROTON,WATER,PPI
PWY0-1353	E-,FUM,SUC,PROTON,|Ubiquinones|,WATER,OXYGEN-MOLECULE,|Ubiquinols|
CARNMET-PWY	|ETF-Reduced|,|ETF-Oxidized|,PROTON,GAMMA-BUTYROBETAINE,GAMMA-BUTYROBETAINYL-COA,WATER,CROTONOBETAINYL-COA,PPI,AMP,L-CARNITINYL-COA,CO-A,CARNITINE,ATP
PWY0-1565	E-,PYRUVATE,D-LACTATE,PROTON,|Ubiquinones|,WATER,OXYGEN-MOLECULE,|Ubiquinols|
GLUTAMINDEG-PWY	AMMONIUM,GLT,GLN,WATER
PWY-7545	E-,ACET,CARBON-DIOXIDE,PYRUVATE,PROTON,|Ubiquinones|,WATER,OXYGEN-MOLECULE,|Ubiquinols|
FASYN-ELONG-PWY	WATER,NADH,NAD,OH-ACYL-ACP,CARBON-DIOXIDE,B-KETOACYL-ACP,ACP,MALONYL-ACP,PROTON,TRANS-D2-ENOYL-ACP,NADPH,|Saturated-Fatty-Acyl-ACPs|,NADP
PWY0-1335	E-,NAD,NADH,PROTON,|Ubiquinones|,WATER,OXYGEN-MOLECULE,|Ubiquinols|
PWY-5965	|Acetoacetyl-ACPs|,ACP,CARBON-DIOXIDE,ACETYL-ACP,MALONYL-ACP,PROTON
PWY0-1561	E-,DIHYDROXY-ACETONE-PHOSPHATE,GLYCEROL-3P,PROTON,|Ubiquinones|,WATER,OXYGEN-MOLECULE,|Ubiquinols|
PWY-4381	ACP,CARBON-DIOXIDE,CO-A,|Acetoacetyl-ACPs|,MALONYL-ACP,PROTON,|biotin-L-lysine-in-BCCP-dimers|,MALONYL-COA,ACETYL-COA,|carboxybiotin-L-lysine-in-BCCP-dimers|
PWY0-1568	E-,NAD,NADH,PROTON,|Ubiquinones|,WATER,OXYGEN-MOLECULE,|Ubiquinols|
PWY0-881	|Cis-Delta5-dodecenoyl-ACPs|,|Trans-D3-cis-D5-dodecenoyl-ACPs|,|b-Hydroxy-cis-D5-dodecenoyl-ACPs|,|b-Keto-cis-D5-dodecenoyl-ACPs|,|Cis-delta-3-decenoyl-ACPs|,|Trans-D2-decenoyl-ACPs|,|Beta-hydroxydecanoyl-ACPs|,CO-A,|Acetoacetyl-ACPs|,|biotin-L-lysine-in-BCCP-dimers|,MALONYL-COA,ACETYL-COA,|carboxybiotin-L-lysine-in-BCCP-dimers|,ACETYL-ACP,WATER,NADH,NAD,OH-ACYL-ACP,CARBON-DIOXIDE,B-KETOACYL-ACP,ACP,MALONYL-ACP,PROTON,TRANS-D2-ENOYL-ACP,NADPH,|Saturated-Fatty-Acyl-ACPs|,NADP
FASYN-INITIAL-PWY	ACP,CO-A,|Acetoacetyl-ACPs|,|biotin-L-lysine-in-BCCP-dimers|,MALONYL-COA,ACETYL-COA,|carboxybiotin-L-lysine-in-BCCP-dimers|,CARBON-DIOXIDE,ACETYL-ACP,MALONYL-ACP,PROTON
TRESYN-PWY	UDP,PROTON,CPD-12575,|D-glucopyranose-6-phosphate|,|Pi|,TREHALOSE,TREHALOSE-6P,WATER
PWY-5966	CARBON-DIOXIDE,|Acetoacetyl-ACPs|,MALONYL-ACP,PROTON,CO-A,ACETYL-ACP,ACP,ACETYL-COA
PWY-6708	|Acceptor|,|Donor-H2|,CPD-9956,OCTAPRENYL-METHYL-OH-METHOXY-BENZQ,OCTAPRENYL-METHYL-METHOXY-BENZQ,OCTAPRENYL-METHOXY-BENZOQUINONE,ADENOSYL-HOMO-CYS,2-OCTAPRENYL-6-METHOXYPHENOL,S-ADENOSYLMETHIONINE,NADP,WATER,2-OCTAPRENYL-6-HYDROXYPHENOL,OXYGEN-MOLECULE,NADPH,CARBON-DIOXIDE,2-OCTAPRENYLPHENOL,PROTON,3-OCTAPRENYL-4-HYDROXYBENZOATE,PPI,OCTAPRENYL-DIPHOSPHATE,|4-hydroxybenzoate|
GLYCOGENSYNTH-PWY	|Phosphorylated-phosphoglucomutase|,ALPHA-GLUCOSE-16-BISPHOSPHATE,|Phosphoglucomutase|,ADP,|Glycogens|,|1-4-alpha-D-Glucan|,PPI,ADP-D-GLUCOSE,PROTON,ATP,|D-glucopyranose-6-phosphate|,GLC-1-P
PWY-5484	23-DIPHOSPHOGLYCERATE,|Protein-Histidines|,|Protein-pi-phospho-L-histidines|,CPD-16758,NADH,DPG,NAD,GAP,DIHYDROXY-ACETONE-PHOSPHATE,ADP,AMP,PHOSPHO-ENOL-PYRUVATE,PROTON,PYRUVATE,ATP,|Pi|,FRUCTOSE-6P,FRUCTOSE-16-DIPHOSPHATE,WATER,G3P,2-PG
SERSYN-PWY	GLT,2-KETOGLUTARATE,NADH,3-P-HYDROXYPYRUVATE,PROTON,G3P,NAD,|Pi|,SER,3-P-SERINE,WATER
GLYCOLYSIS	23-DIPHOSPHOGLYCERATE,|Protein-Histidines|,|Protein-pi-phospho-L-histidines|,CPD-16758,NADH,DPG,NAD,GAP,DIHYDROXY-ACETONE-PHOSPHATE,ADP,|D-glucopyranose-6-phosphate|,AMP,PHOSPHO-ENOL-PYRUVATE,PROTON,PYRUVATE,ATP,|Pi|,FRUCTOSE-6P,FRUCTOSE-16-DIPHOSPHATE,WATER,G3P,2-PG
PWY-5973	CPD-9247,ACP,CARBON-DIOXIDE,|Palmitoleoyl-ACPs|,MALONYL-ACP,NADPH,|3-oxo-cis-vaccenoyl-ACPs|,NADP,WATER,|R-3-hydroxy-cis-vaccenoyl-ACPs|,PROTON,NADH,|cis-vaccen-2-enoyl-ACPs|,|Cis-vaccenoyl-ACPs|,NAD
SERDEG-PWY	SER,2-AMINOACRYLATE,AMMONIUM,PYRUVATE,CPD-16015,WATER
PWY-6284	|Trans-D3-cis-D5-dodecenoyl-ACPs|,|b-Hydroxy-cis-D5-dodecenoyl-ACPs|,|b-Keto-cis-D5-dodecenoyl-ACPs|,|Cis-delta-3-decenoyl-ACPs|,|Trans-D2-decenoyl-ACPs|,|Beta-hydroxydecanoyl-ACPs|,|Trans-D3-cis-D9-hexadecenoyl-ACPs|,|3-hydroxy-cis-D9-hexaecenoyl-ACPs|,|3-oxo-cis-D9-hexadecenoyl-ACPs|,|Cis-Delta7-tetradecenoyl-ACPs|,|Trans-D2-cis-D7-tetradecenoyl-ACPs|,|3-hydroxy-cis-D7-tetraecenoyl-ACPs|,|3-oxo-cis-D7-tetradecenoyl-ACPs|,|Cis-Delta5-dodecenoyl-ACPs|,CPD-9245,CPD-9247,ACP,CARBON-DIOXIDE,|Palmitoleoyl-ACPs|,MALONYL-ACP,NADPH,|3-oxo-cis-vaccenoyl-ACPs|,NADP,WATER,|R-3-hydroxy-cis-vaccenoyl-ACPs|,PROTON,NADH,|cis-vaccen-2-enoyl-ACPs|,|Cis-vaccenoyl-ACPs|,NAD
PWY0-862	NADH,NAD,|Cis-Delta5-dodecenoyl-ACPs|,|Trans-D3-cis-D5-dodecenoyl-ACPs|,NADPH,|b-Hydroxy-cis-D5-dodecenoyl-ACPs|,NADP,CARBON-DIOXIDE,ACP,|b-Keto-cis-D5-dodecenoyl-ACPs|,MALONYL-ACP,PROTON,|Cis-delta-3-decenoyl-ACPs|,WATER,|Trans-D2-decenoyl-ACPs|,|Beta-hydroxydecanoyl-ACPs|
PWY-4621	WATER,|Ox-Glutaredoxins|,CPD-763,ARSENATE,|Red-Glutaredoxins|,PROTON
RIBOSYN2-PWY	ADP,FAD,FMN,ATP,RIBOFLAVIN,DIMETHYL-D-RIBITYL-LUMAZINE,|Pi|,AMINO-RIBOSYLAMINO-1H-3H-PYR-DIONE,DIHYDROXY-BUTANONE-P,RIBULOSE-5P,NADPH,CPD-1086,NADP,AMMONIUM,CPD-602,FORMATE,DIAMINO-OH-PHOSPHORIBOSYLAMINO-PYR,PPI,PROTON,WATER,GTP
PWY0-1597	CPD-4211,WATER,PROTON,ADP,PRENOL,ATP,|Pi|,CPD-18260,FMNH2,CPD-14332
GLUTSYN-PWY	WATER,AMMONIUM,NADPH,2-KETOGLUTARATE,GLN,PROTON,GLT,NADP
GLUTSYNIII-PWY	NADPH,2-KETOGLUTARATE,AMMONIUM,PROTON,GLT,WATER,NADP
PWY-1801	FORMATE,WATER,GLUTATHIONE,FORMALDEHYDE,PROTON,CPD-548,NADH-P-OR-NOP,NAD-P-OR-NOP,S-HYDROXYMETHYLGLUTATHIONE
PWY0-1298	AMMONIUM,WATER,DEOXYCYTIDINE,URACIL,DEOXYURIDINE,THYMINE,THYMIDINE,|Pi|,DEOXY-D-RIBOSE-1-PHOSPHATE,GAP,DEOXY-RIBOSE-5P,ACETYL-COA,NADH,PROTON,NAD,CO-A,ACETALD
PWY0-1477	AMMONIUM,ETHANOL-AMINE,CO-A,|Pi|,ACETYL-COA,ADP,ACETYL-P,ACET,ATP,PROTON,NADH,ACETALD,ETOH,NAD
PWY-6071	HYDROGEN-PEROXIDE,AMMONIUM,PHENYLETHYLAMINE,PHENYLACETALDEHYDE,SUC-COA,NADH,3-KETO-ADIPYL-COA,NAD,OXYGEN-MOLECULE,ACETYL-COA,CPD0-2362,CPD0-2363,PROTON,NADPH,CPD0-2364,CPDMETA-13650,NADP,AMP,PPI,CPD-207,CO-A,PHENYLACETATE,ATP,WATER,TRANS-23-DEHYDROADIPYL-COA,3-HYDROXYADIPYL-COA
PWY0-981	CARBON-DIOXIDE,SUC,SO3,CPD-1772,PROTON,TAURINE,2-KETOGLUTARATE,OXYGEN-MOLECULE
ORNDEG-PWY	CARBON-DIOXIDE,L-ORNITHINE,NADH,NAD,2-KETOGLUTARATE,4-AMINO-BUTYRATE,NADH-P-OR-NOP,CPD-9000,NAD-P-OR-NOP,AMMONIUM,HYDROGEN-PEROXIDE,GAMMA-GLUTAMYL-GAMMA-AMINOBUTYRALDEH,OXYGEN-MOLECULE,|Pi|,ADP,GAMMA-GLUTAMYL-PUTRESCINE,PROTON,PUTRESCINE,GLT,ATP,WATER,CPD-6124,4-AMINO-BUTYRALDEHYDE
GLCMANNANAUT-PWY	FRUCTOSE-6P,AMMONIUM,CPD-13469,ACET,D-GLUCOSAMINE-6-P,WATER,N-ACETYL-D-GLUCOSAMINE-6-P,PYRUVATE,N-ACETYLNEURAMINATE,ADP,N-ACETYL-D-MANNOSAMINE-6P,PROTON,|N-acetyl-D-mannosamine|,ATP
SULFATE-CYS-PWY	|Red-Thioredoxin|,3-5-ADP,|Ox-Thioredoxin|,SO3,NADPH,NADP,PPI,SULFATE,ADP,PAPS,APS,ATP,CO-A,ACETYL-COA,ACET,CYS,ACETYLSERINE,HS,GLT,2-KETOGLUTARATE,NADH,3-P-HYDROXYPYRUVATE,PROTON,G3P,NAD,|Pi|,SER,3-P-SERINE,WATER
ALKANEMONOX-PWY	NADPH,NADP,PROTON,FMN,WATER,SO3,|Aldehydes|,|Alkanesulfonates|,OXYGEN-MOLECULE,FMNH2
SO4ASSIM-PWY	|Red-Thioredoxin|,3-5-ADP,|Ox-Thioredoxin|,SO3,NADPH,WATER,NADP,HS,PPI,SULFATE,ADP,PAPS,PROTON,APS,ATP
PWY-6153	CPD-10774,CPD-10773,PROTON,|Methylated-methyl-acceptors|,S-ADENOSYLMETHIONINE,|Demethylated-methyl-acceptors|,ADENINE,ADENOSYL-HOMO-CYS,WATER,DIHYDROXYPENTANEDIONE,HOMO-CYS,CPD-564
GLYSYN-PWY	WATER,METHYLENE-THF-GLU-N,GLY,SER,THF-GLU-N
COLANSYN-PWY	|Phosphorylated-phosphoglucomutase|,ALPHA-GLUCOSE-16-BISPHOSPHATE,|Phosphoglucomutase|,CPD-14553,GDP-4-DEHYDRO-6-DEOXY-D-MANNOSE,NADPH,GDP-4-DEHYDRO-6-L-DEOXYGALACTOSE,CPD-13118,NADP,FRUCTOSE-6P,CPD-15979,GDP-MANNOSE,MANNOSE-1P,GTP,PPI,UTP,|D-glucopyranose-6-phosphate|,GLC-1-P,UDP-GLUCURONATE,NADH,PROTON,CPD-12575,WATER,NAD
PLPSAL-PWY	PYRIDOXINE,PYRIDOXAMINE,PYRIDOXINE-5P,HYDROGEN-PEROXIDE,AMMONIUM,OXYGEN-MOLECULE,WATER,PYRIDOXAMINE-5P,PYRIDOXAL_PHOSPHATE,ADP,PROTON,ATP,PYRIDOXAL
HOMOSERSYN-PWY	ADP,L-ASPARTATE,ATP,L-BETA-ASPARTYL-P,NADPH,NADP,|Pi|,PROTON,L-ASPARTATE-SEMIALDEHYDE,NADH-P-OR-NOP,NAD-P-OR-NOP,HOMO-SER
PWY-5155	CARBON-DIOXIDE,B-ALANINE,PROTON,L-ASPARTATE
PYRIDOXSYN-PWY	PYRIDOXAL_PHOSPHATE,HYDROGEN-PEROXIDE,OXYGEN-MOLECULE,ERYTHROSE-4P,PYRUVATE,GAP,WATER,|Pi|,PYRIDOXINE-5P,DEOXYXYLULOSE-5P,PROTON,ERYTHRONATE-4P,2-KETOGLUTARATE,3OH-4P-OH-ALPHA-KETOBUTYRATE,GLT,NADH,CARBON-DIOXIDE,1-AMINO-PROPAN-2-ONE-3-PHOSPHATE,4-PHOSPHONOOXY-THREONINE,NAD
PWY-6894	ADP,THIAMINE-PYROPHOSPHATE,ATP,PPI,CARBON-DIOXIDE,THIAMINE-P,CPD-13575,AMINO-HYDROXYMETHYL-METHYLPYRIMIDINE-PP,PROTON
PWY-7181	AMMONIUM,PROTON,WATER,DEOXYCYTIDINE,URACIL,DEOXYURIDINE,THYMINE,DEOXY-D-RIBOSE-1-PHOSPHATE,THYMIDINE,|Pi|
PWY-6892	WATER,CPD-13575,DEOXYXYLULOSE-5P,CARBON-DIOXIDE,PYRUVATE,GAP,|Oxidized-ferredoxins|,AMP,|Thiocarboxyadenylated-ThiS-Proteins|,|Reduced-ferredoxins|,PPI,|Adenylated-ThiS-Proteins|,|Thi-S|,ATP,PROTON,NADP,MET,CH33ADO,CPD-108,CPD-12279,S-ADENOSYLMETHIONINE,TYR,NADPH,|Sulfurylated-ThiI|,|Sulfur-Carrier-Proteins-ThiI|,L-ALPHA-ALANINE,|L-Cysteine-Desulfurase-persulfide|,|Cysteine-Desulfurase-L-cysteine|,CYS
THRDLCTCAT-PWY	NADH,THR,NAD,CARBON-DIOXIDE,AMINO-OXOBUT,PROTON,HYDROGEN-PEROXIDE,AMMONIUM,METHYL-GLYOXAL,AMINO-ACETONE,WATER,OXYGEN-MOLECULE
PWY0-1295	AMMONIUM,PROTON,WATER,CYTIDINE,URACIL,|Pi|,URIDINE,RIBOSE-5P,RIBOSE-1P
PWY-40	CARBON-DIOXIDE,PROTON,ARG,PUTRESCINE,UREA,WATER,AGMATHINE
PWY-5437	FORMATE,CO-A,PROPIONYL-COA,|Pi|,PROPIONYL-P,ADP,ATP,PROPIONATE,THR,AMMONIUM,2-OXOBUTANOATE,PROTON,WATER,CPD-16013,CPD-15056
PWY-46	PUTRESCINE,CARBON-DIOXIDE,PROTON,L-ORNITHINE
PWY-6268	P3I,ATP,CPD-20905,CPD-20904,|Reduced-Flavoproteins|,CPD-1829,COB-I-ALAMIN,|Oxidized-Flavoproteins|,PROTON,|Corrinoid-Adenosyltransferases|,ADENOSYLCOBALAMIN,|B12-Corrinoid-Adenosyltranferase|
PHOSLIPSYN-PWY	PPI,CTP,CO-A,ACYL-COA,DIHYDROXY-ACETONE-PHOSPHATE,NADH-P-OR-NOP,NAD-P-OR-NOP,|Pi|,WATER,GLYCEROL,L-1-PHOSPHATIDYL-GLYCEROL-P,CMP,CDPDIACYLGLYCEROL,SER,CARBON-DIOXIDE,L-1-PHOSPHATIDYL-SERINE,PROTON,L-PHOSPHATIDATE,ACP,ACYL-SN-GLYCEROL-3P,GLYCEROL-3P,ACYL-ACP,ETHANOL-AMINE,CARDIOLIPIN,L-1-PHOSPHATIDYL-GLYCEROL,L-1-PHOSPHATIDYL-ETHANOLAMINE
COBALSYN-PWY	PPI,GTP,ADP,ADENOSYLCOBINAMIDE-P,NIACINE,NICOTINATE_NUCLEOTIDE,DIMETHYLBENZIMIDAZOLE,|Pi|,ADENOSYLCOBALAMIN,WATER,GMP,ADENOSYLCOBALAMIN-5-P,ADENOSYLCOBINAMIDE-GDP,ALPHA-RIBAZOLE-5-P,CPD-20903,PROTON,|Oxidized-Flavoproteins|,|Reduced-Flavoproteins|,CPD-20906,|Corrinoid-Adenosyltransferases|,P3I,ADENOSYLCOBINAMIDE,ATP,CPD-20907
HEMESYN2-PWY	E-,FE+2,PROTOHEME,PROTON,UROPORPHYRINOGEN-III,CH33ADO,MET,CARBON-DIOXIDE,S-ADENOSYLMETHIONINE,COPROPORPHYRINOGEN_III,PROTOPORPHYRINOGEN,|Menaquinones|,|Menaquinols|,PROTOPORPHYRIN_IX
PWY-7971	PPI,ADENOSYLCOBINAMIDE-GDP,GTP,ADP,ADENOSYLCOBINAMIDE-P,CPD-20903,PROTON,|Oxidized-Flavoproteins|,|Reduced-Flavoproteins|,CPD-20906,|Corrinoid-Adenosyltransferases|,P3I,ADENOSYLCOBINAMIDE,ATP,CPD-20907
HEME-BIOSYNTHESIS-II	UROPORPHYRINOGEN-III,HYDROGEN-PEROXIDE,FE+2,PROTOPORPHYRIN_IX,PROTOHEME,WATER,CARBON-DIOXIDE,PROTOPORPHYRINOGEN,COPROPORPHYRINOGEN_III,OXYGEN-MOLECULE,PROTON
PWY0-1415	E-,UROPORPHYRINOGEN-III,HYDROGEN-PEROXIDE,FE+2,PROTOHEME,WATER,OXYGEN-MOLECULE,PROTON,CH33ADO,MET,CARBON-DIOXIDE,S-ADENOSYLMETHIONINE,COPROPORPHYRINOGEN_III,PROTOPORPHYRINOGEN,|Menaquinones|,|Menaquinols|,PROTOPORPHYRIN_IX
UDPNAGSYN-PWY	|Phosphorylated-Phosphoglucosamine-Mutase|,CPD0-1096,|Phosphoglucosamine-Mutase|,PPI,UDP-N-ACETYL-D-GLUCOSAMINE,UTP,CO-A,N-ACETYL-D-GLUCOSAMINE-1-P,PROTON,ACETYL-COA,GLT,GLN,GLUCOSAMINE-1P,D-GLUCOSAMINE-6-P,FRUCTOSE-6P,|D-glucopyranose-6-phosphate|
PWY0-1319	DIHYDROXY-ACETONE-PHOSPHATE,NADH-P-OR-NOP,NAD-P-OR-NOP,CDPDIACYLGLYCEROL,PPI,CTP,L-PHOSPHATIDATE,PROTON,ACP,ACYL-SN-GLYCEROL-3P,GLYCEROL-3P,ACYL-ACP
PWY-5667	CDPDIACYLGLYCEROL,PPI,CTP,L-PHOSPHATIDATE,CO-A,ACYL-SN-GLYCEROL-3P,ACYL-COA,PROTON,DIHYDROXY-ACETONE-PHOSPHATE,NADH-P-OR-NOP,NAD-P-OR-NOP,GLYCEROL-3P
PWY-5436	GLY,THR,ACETYL-COA,NADH,PROTON,NAD,CO-A,ACETALD
TRPSYN-PWY	CARBON-DIOXIDE,CARBOXYPHENYLAMINO-DEOXYRIBULOSE-P,PRPP,N-5-PHOSPHORIBOSYL-ANTHRANILATE,PPI,GLT,PYRUVATE,ANTHRANILATE,PROTON,CHORISMATE,GLN,GAP,INDOLE-3-GLYCEROL-P,WATER,TRP,INDOLE,SER
THREONINE-DEG2-PWY	PROTON,NADH,THR,NAD,CO-A,AMINO-OXOBUT,GLY,ACETYL-COA
PWY-6151	ADENINE,DIHYDROXYPENTANEDIONE,CPD-564,PPI,|Pi|,ATP,WATER,PROTON,|Methylated-methyl-acceptors|,ADENOSYL-HOMO-CYS,S-ADENOSYLMETHIONINE,|Demethylated-methyl-acceptors|,CPD-1301,MET,CPD-1302,HOMO-CYS
PWY-5350	PROTON,SO3,HSCN,S2O3,HCN
UBISYN-PWY	PYRUVATE,CHORISMATE,|Acceptor|,|Donor-H2|,CPD-9956,OCTAPRENYL-METHYL-OH-METHOXY-BENZQ,OCTAPRENYL-METHYL-METHOXY-BENZQ,OCTAPRENYL-METHOXY-BENZOQUINONE,ADENOSYL-HOMO-CYS,2-OCTAPRENYL-6-METHOXYPHENOL,S-ADENOSYLMETHIONINE,NADP,WATER,2-OCTAPRENYL-6-HYDROXYPHENOL,OXYGEN-MOLECULE,NADPH,CARBON-DIOXIDE,2-OCTAPRENYLPHENOL,PROTON,3-OCTAPRENYL-4-HYDROXYBENZOATE,|4-hydroxybenzoate|,OCTAPRENYL-DIPHOSPHATE,PPI,FARNESYL-PP,GERANYL-PP,CPD-4211,DELTA3-ISOPENTENYL-PP
PWY-5901	CHORISMATE,PYRUVATE,WATER,ISOCHORISMATE,2-3-DIHYDROXYBENZOATE,NADH,PROTON,NAD,DIHYDRO-DIOH-BENZOATE
GALACT-GLUCUROCAT-PWY	ADP,ATP,D-ALTRONATE,D-TAGATURONATE,CPD-15633,PYRUVATE,GAP,2-KETO-3-DEOXY-6-P-GLUCONATE,NADH,PROTON,NAD,2-DEHYDRO-3-DEOXY-D-GLUCONATE,D-MANNONATE,FRUCTURONATE,|Alcohols|,WATER,|Beta-D-Glucuronides|,CPD-15530,|D-Glucopyranuronate|
VALSYN-PWY	WATER,GLT,2-KETO-ISOVALERATE,VAL,2-KETOGLUTARATE,NADPH,CPD-13357,NADP,CARBON-DIOXIDE,2-ACETO-LACTATE,PROTON,PYRUVATE
PWY0-166	AMMONIUM,PPI,DIHYDROFOLATE-GLU-N,METHYLENE-THF-GLU-N,DUMP,TMP,ADP,TTP,TDP,ATP,|Red-Thioredoxin|,|Ox-Thioredoxin|,UDP,DUDP,|Reduced-NrdH-Proteins|,DCDP,|Oxidized-NrdH-Proteins|,DUTP,UTP,CARBON-DIOXIDE,DCTP,FORMATE,CDP,|Pi|,PROTON,WATER,CTP
XYLCAT-PWY	ADP,XYLULOSE-5-PHOSPHATE,PROTON,ATP,D-XYLULOSE,|D-Xylose|
PWY0-781	OXALACETIC_ACID,L-BETA-ASPARTYL-P,NADPH,NADP,ADP,THR,O-PHOSPHO-L-HOMOSERINE,LYS,MESO-DIAMINOPIMELATE,LL-DIAMINOPIMELATE,2-KETOGLUTARATE,N-SUCCINYLLL-2-6-DIAMINOPIMELATE,N-SUCCINYL-2-AMINO-6-KETOPIMELATE,L-ASPARTATE-SEMIALDEHYDE,NADH-P-OR-NOP,CPD-14443,DELTA1-PIPERIDEINE-2-6-DICARBOXYLATE,NAD-P-OR-NOP,CO-A,HOMO-SER,SUC-COA,CPD-1301,CPD-1302,THF-GLU-N,5-METHYL-THF-GLU-N,SUC,CYS,O-SUCCINYL-L-HOMOSERINE,HOMO-CYS,L-CYSTATHIONINE,2-AMINOACRYLATE,PYRUVATE,CPD-16015,GLT,GLN,NAD,AMP,AMMONIUM,DEAMIDO-NAD,PRPP,NICOTINATE_NUCLEOTIDE,CARBON-DIOXIDE,QUINOLINATE,DIHYDROXY-ACETONE-PHOSPHATE,IMINOASPARTATE,HYDROGEN-PEROXIDE,PROTON,OXYGEN-MOLECULE,L-ASPARTATE,PPI,|Pi|,S-ADENOSYLMETHIONINE,ATP,MET,WATER
TCA-GLYOX-BYPASS	|Oxo-glutarate-dehydrogenase-lipoyl|,|Oxo-glutarate-dehydro-suc-DH-lipoyl|,|Oxo-glutarate-dehydrogenase-DH-lipoyl|,OXALO-SUCCINATE,E-,GLYOX,PROTON,ACETYL-COA,CIS-ACONITATE,CIT,WATER,|Pi|,ADP,ATP,NADH,SUC-COA,CO-A,NAD,CARBON-DIOXIDE,2-KETOGLUTARATE,NADPH,THREO-DS-ISO-CITRATE,NADP,FUM,|Ubiquinols|,|Ubiquinones|,SUC,OXALACETIC_ACID,|ETR-Quinols|,|ETR-Quinones|,MAL
PWY0-1471	FMN,URACIL,OXYGEN-MOLECULE,FMNH2,CARBON-DIOXIDE,AMMONIUM,NADPH,MALONATE-S-ALD,3-HYDROXY-PROPIONATE,NADP,CARBAMATE,CPD0-2338,|Acceptor|,PROTON,WATER,CPD0-2339,CPD0-2340,|Donor-H2|
THRESYN-PWY	L-BETA-ASPARTYL-P,NADPH,NADP,L-ASPARTATE-SEMIALDEHYDE,NADH-P-OR-NOP,NAD-P-OR-NOP,ADP,PROTON,HOMO-SER,ATP,THR,|Pi|,O-PHOSPHO-L-HOMOSERINE,WATER,GLT,OXALACETIC_ACID,L-ASPARTATE,2-KETOGLUTARATE
HOMOSER-THRESYN-PWY	ADP,PROTON,HOMO-SER,ATP,THR,|Pi|,O-PHOSPHO-L-HOMOSERINE,WATER
ALL-CHORISMATE-PWY	|Acceptor|,|Donor-H2|,CPD-9956,OCTAPRENYL-METHYL-OH-METHOXY-BENZQ,OCTAPRENYL-METHYL-METHOXY-BENZQ,OCTAPRENYL-METHOXY-BENZOQUINONE,2-OCTAPRENYL-6-METHOXYPHENOL,2-OCTAPRENYL-6-HYDROXYPHENOL,OXYGEN-MOLECULE,2-OCTAPRENYLPHENOL,3-OCTAPRENYL-4-HYDROXYBENZOATE,|4-hydroxybenzoate|,FARNESYL-PP,GERANYL-PP,CPD-4211,DELTA3-ISOPENTENYL-PP,3-DEOXY-D-ARABINO-HEPTULOSONATE-7-P,ERYTHROSE-4P,3-ENOLPYRUVYL-SHIKIMATE-5P,PHOSPHO-ENOL-PYRUVATE,SHIKIMATE-5P,SHIKIMATE,3-DEHYDRO-SHIKIMATE,DEHYDROQUINATE,CARBOXYPHENYLAMINO-DEOXYRIBULOSE-P,PRPP,N-5-PHOSPHORIBOSYL-ANTHRANILATE,ANTHRANILATE,GAP,INDOLE-3-GLYCEROL-P,TRP,INDOLE,PHE,PHENYL-PYRUVATE,TYR,P-HYDROXY-PHENYLPYRUVATE,PREPHENATE,NADH,NAD,DIHYDRO-DIOH-BENZOATE,|Apo-EntB|,2-3-DIHYDROXYBENZOATE,CPD-62,SER,3-5-ADP,|Apo-EntF|,SERYL-AMP,|Holo-EntB|,|23DHB-EntB|,|Seryl-EntF|,|Holo-EntF|,ENTEROBACTIN,|DHB-Seryl-EntF|,O-SUCCINYLBENZOATE,ISOCHORISMATE,2-KETOGLUTARATE,CPD-9923,CPD-9924,CPD-6972,CO-A,CPD-9925,CARBON-DIOXIDE,OCTAPRENYL-DIPHOSPHATE,DIHYDROXYNAPHTHOATE,ADENOSYL-HOMO-CYS,REDUCED-MENAQUINONE,S-ADENOSYLMETHIONINE,CPD-12115,ADP,DIHYDROFOLATE,7-8-DIHYDROPTEROATE,NADPH,DIHYDROFOLATE-GLU-N,THF-GLU-N,NADP,AMP,DIHYDROPTERIN-CH2OH-PP,ATP,AMINO-OH-HYDROXYMETHYL-DIHYDROPTERIDINE,GLYCOLALDEHYDE,|Pi|,DIHYDRO-NEO-PTERIN,PPI,DIHYDRONEOPTERIN-P,DIHYDRONEOPTERIN-P3,FORMATE,GTP,WATER,GLT,GLN,CHORISMATE,PYRUVATE,P-AMINO-BENZOATE,PROTON,4-AMINO-4-DEOXYCHORISMATE
FUC-RHAMCAT-PWY	E-,FUCULOSE-1P,L-FUCULOSE,CPD0-1107,CPD-10329,DIHYDROXY-ACETONE-PHOSPHATE,ADP,RHAMNULOSE-1P,ATP,CPD-16567,CPD-16566,CPD0-1112,RHAMNOSE,WATER,PYRUVATE,|ETR-Quinols|,|ETR-Quinones|,L-LACTATE,PROTON,NADH,LACTALD,PROPANE-1-2-DIOL,NAD
PWY-6164	DEHYDROQUINATE,|Pi|,3-DEOXY-D-ARABINO-HEPTULOSONATE-7-P,PHOSPHO-ENOL-PYRUVATE,ERYTHROSE-4P,WATER
PWY0-162	CARBAMATE,CPD-18238,E-,AMMONIUM,HCO3,L-ASPARTATE,CARBAMOYL-P,CARBAMYUL-L-ASPARTATE,PRPP,PPI,CARBON-DIOXIDE,OROTIDINE-5-PHOSPHATE,OROTATE,|ETR-Quinols|,|ETR-Quinones|,DI-H-OROTATE,UMP,UDP,GLT,CTP,|Pi|,ADP,PROTON,ATP,UTP,GLN,WATER
GLUCONSUPER-PWY	CPD-2961,ADP,PROTON,ATP,GLUCONATE
PWY0-1313	AMP,PPI,ACETYL-COA,CO-A,ACET,ATP
GLUCARGALACTSUPER-PWY	PYRUVATE,TARTRONATE-S-ALD,NADH-P-OR-NOP,NAD-P-OR-NOP,D-GLUCARATE,ADP,2-PG,PROTON,ATP,GLYCERATE,WATER,5-KETO-4-DEOXY-D-GLUCARATE,D-GALACTARATE
ACETATEUTIL-PWY	AMP,PPI,ADP,ACET,ATP,CO-A,ACETYL-P,|Pi|,ACETYL-COA
PWY-6703	FORMATE,GTP,ACETALD,P3I,DIHYDRONEOPTERIN-P3,CPD0-1699,WATER,|Pi|,ADP,7-CYANO-7-DEAZAGUANINE,PROTON,CPD-13043,AMMONIUM,ATP
PWY-1269	PPI,CMP-KDO,CTP,KDO,|Pi|,KDO-8P,WATER,PHOSPHO-ENOL-PYRUVATE,RIBULOSE-5P,CPD-18118,ARABINOSE-5P
PRPP-PWY	CARBAMATE,CPD-18238,E-,AMMONIUM,HIS,HISTIDINAL,HISTIDINOL,L-HISTIDINOL-P,2-KETOGLUTARATE,IMIDAZOLE-ACETOL-P,D-ERYTHRO-IMIDAZOLE-GLYCEROL-P,PHOSPHORIBULOSYL-FORMIMINO-AICAR-P,PHOSPHORIBOSYL-FORMIMINO-AICAR-P,PHOSPHORIBOSYL-AMP,PHOSPHORIBOSYL-ATP,5-P-BETA-D-RIBOSYL-AMINE,GLY,5-PHOSPHORIBOSYL-N-FORMYLGLYCINEAMIDINE,5-P-RIBOSYL-N-FORMYLGLYCINEAMIDE,5-PHOSPHO-RIBOSYL-GLYCINEAMIDE,P-RIBOSYL-4-SUCCCARB-AMINOIMIDAZOLE,THF-GLU-N,FORMYL-THF-GLU-N,AICAR,PHOSPHORIBOSYL-FORMAMIDO-CARBOXAMIDE,PHOSPHORIBOSYL-CARBOXY-AMINOIMIDAZOLE,CPD0-181,5-PHOSPHORIBOSYL-5-AMINOIMIDAZOLE,NADH,NAD,XANTHOSINE-5-PHOSPHATE,GMP,DGTP,DGDP,GDP,IMP,GTP,FUM,ADENYLOSUCC,|Red-Thioredoxin|,|Ox-Thioredoxin|,|Reduced-NrdH-Proteins|,|Oxidized-NrdH-Proteins|,DADP,DATP,FORMATE,HCO3,L-ASPARTATE,CARBAMOYL-P,CARBAMYUL-L-ASPARTATE,PPI,CARBON-DIOXIDE,OROTIDINE-5-PHOSPHATE,OROTATE,|ETR-Quinols|,|ETR-Quinones|,DI-H-OROTATE,UMP,UDP,GLT,CTP,|Pi|,ADP,UTP,GLN,WATER,AMP,PRPP,PROTON,RIBOSE-5P,ATP
PYRUVDEHYD-PWY	THIAMINE-PYROPHOSPHATE,2-ALPHA-HYDROXYETHYL-THPP,CO-A,ACETYL-COA,NADH,|Pyruvate-dehydrogenase-dihydrolipoate|,NAD,CARBON-DIOXIDE,|Pyruvate-dehydrogenase-acetylDHlipoyl|,PYRUVATE,|Pyruvate-dehydrogenase-lipoate|,PROTON
PWY-6038	ACET,CIT,PROTON,CITRATE-LYASE,OXALACETIC_ACID,|Citrate-Lyase-Citryl-Form|
PWY-5162	WATER,CPD-14447,PYRUVATE,4-HYDROXY-2-KETOVALERATE,ACETYL-COA,NADH,PROTON,NAD,CO-A,ACETALD
PWY-7211	CARBAMATE,CPD-18238,E-,AMMONIUM,DCTP,DUTP,DIHYDROFOLATE-GLU-N,METHYLENE-THF-GLU-N,DUMP,TMP,TTP,TDP,DUDP,|Red-Thioredoxin|,DCDP,|Ox-Thioredoxin|,CDP,HCO3,L-ASPARTATE,CARBAMOYL-P,CARBAMYUL-L-ASPARTATE,PRPP,PPI,CARBON-DIOXIDE,OROTIDINE-5-PHOSPHATE,OROTATE,|ETR-Quinols|,|ETR-Quinones|,DI-H-OROTATE,UMP,UDP,GLT,CTP,|Pi|,ADP,PROTON,ATP,UTP,GLN,WATER
PWY0-1465	PYRUVATE,CARBON-DIOXIDE,NADH,NAD,CPD-660
ORNARGDEG-PWY	NADH-P-OR-NOP,CPD-9000,NAD-P-OR-NOP,AMMONIUM,HYDROGEN-PEROXIDE,GAMMA-GLUTAMYL-GAMMA-AMINOBUTYRALDEH,OXYGEN-MOLECULE,|Pi|,ADP,GAMMA-GLUTAMYL-PUTRESCINE,ATP,ARG,UREA,AGMATHINE,NADPH,SUC,SUCC-S-ALD,NADP,NADH,4-AMINO-BUTYRATE,NAD,GLT,2-KETOGLUTARATE,PUTRESCINE,CARBON-DIOXIDE,PROTON,L-ORNITHINE,WATER,CPD-6124,4-AMINO-BUTYRALDEHYDE
MET-SAM-PWY	CO-A,SUC-COA,CPD-1301,CPD-1302,THF-GLU-N,5-METHYL-THF-GLU-N,SUC,CYS,O-SUCCINYL-L-HOMOSERINE,HOMO-CYS,L-CYSTATHIONINE,2-AMINOACRYLATE,AMMONIUM,PYRUVATE,CPD-16015,ADP,L-ASPARTATE,L-BETA-ASPARTYL-P,NADPH,NADP,PROTON,L-ASPARTATE-SEMIALDEHYDE,NADH-P-OR-NOP,NAD-P-OR-NOP,HOMO-SER,PPI,|Pi|,S-ADENOSYLMETHIONINE,ATP,MET,WATER
AST-PWY	CO-A,ARG,SUC-COA,CARBON-DIOXIDE,AMMONIUM,CPD-421,N2-SUCCINYLORNITHINE,2-KETOGLUTARATE,PROTON,NADH,CPD-822,NAD,GLT,SUC,N2-SUCCINYLGLUTAMATE,WATER
ARGDEG-PWY	NADH-P-OR-NOP,CPD-9000,NAD-P-OR-NOP,AMMONIUM,HYDROGEN-PEROXIDE,GAMMA-GLUTAMYL-GAMMA-AMINOBUTYRALDEH,OXYGEN-MOLECULE,|Pi|,ADP,GAMMA-GLUTAMYL-PUTRESCINE,ATP,CARBON-DIOXIDE,ARG,UREA,AGMATHINE,NADPH,SUC,SUCC-S-ALD,NADP,PROTON,NADH,4-AMINO-BUTYRATE,NAD,WATER,GLT,4-AMINO-BUTYRALDEHYDE,PUTRESCINE,2-KETOGLUTARATE
THREOCAT-PWY	ACETALD,NADH,NAD,HYDROGEN-PEROXIDE,METHYL-GLYOXAL,AMINO-ACETONE,OXYGEN-MOLECULE,AMINO-OXOBUT,GLY,ACETYL-COA,FORMATE,CO-A,PROPIONYL-COA,|Pi|,PROPIONYL-P,ADP,ATP,PROPIONATE,THR,AMMONIUM,CPD-16013,CPD-15056,WATER,GLT,2-KETO-3-METHYL-VALERATE,ILE,2-KETOGLUTARATE,NADPH,1-KETO-2-METHYLVALERATE,NADP,CARBON-DIOXIDE,2-ACETO-2-HYDROXY-BUTYRATE,PROTON,PYRUVATE,2-OXOBUTANOATE
PWY0-823	CARBON-DIOXIDE,PROTON,ARG,PUTRESCINE,UREA,WATER,AGMATHINE
PWY-6897	THZ,PPI,THZ-P,THIAMINE-PYROPHOSPHATE,THIAMINE-P,PROTON,HMP,ADP,AMINO-HYDROXYMETHYL-METHYLPYRIMIDINE-PP,AMINO-HYDROXYMETHYL-METHYL-PYR-P,ATP
PWY0-845	PYRIDOXINE,PYRIDOXAMINE,HYDROGEN-PEROXIDE,AMMONIUM,OXYGEN-MOLECULE,PYRIDOXAMINE-5P,PYRIDOXAL_PHOSPHATE,ADP,ATP,PYRIDOXAL,ERYTHROSE-4P,PYRUVATE,GAP,WATER,|Pi|,PYRIDOXINE-5P,DEOXYXYLULOSE-5P,PROTON,ERYTHRONATE-4P,2-KETOGLUTARATE,3OH-4P-OH-ALPHA-KETOBUTYRATE,GLT,NADH,CARBON-DIOXIDE,1-AMINO-PROPAN-2-ONE-3-PHOSPHATE,4-PHOSPHONOOXY-THREONINE,NAD
DETOX1-PWY	PROTON,SUPER-OXIDE,OXYGEN-MOLECULE,WATER,HYDROGEN-PEROXIDE
PWY-5084	CARBON-DIOXIDE,2-KETOGLUTARATE,|Oxo-glutarate-dehydro-suc-DH-lipoyl|,CO-A,SUC-COA,PROTON,NADH,|Oxo-glutarate-dehydrogenase-lipoyl|,|Oxo-glutarate-dehydrogenase-DH-lipoyl|,NAD
PWY0-1569	CO-A,DIHYDROXY-ACETONE-PHOSPHATE,ACETYL-COA,ADP,PROTON,DIHYDROXYPENTANEDIONE,ATP,CPD0-2467,CPD-10551
PWY0-1527	CPD-6602,NADP,CPD-13315,CPD-13314,NADPH,PROTON
PWY0-1581	E-,DIHYDROXY-ACETONE-PHOSPHATE,GLYCEROL-3P,PROTON,WATER,NITRITE,|Menaquinones|,|Menaquinols|,NITRATE
PWY0-1585	E-,CARBON-DIOXIDE,FORMATE,|Menaquinones|,|Menaquinols|,|an-oxidized-NrfB-protein|,WATER,AMMONIUM,|a-reduced-NrfB-protein|,NITRITE,PROTON
PWY0-1336	E-,NAD,PROTON,NADH,SUC,|Menaquinones|,|Menaquinols|,FUM
PWY0-1352	E-,NAD,NADH,PROTON,WATER,NITRITE,|Menaquinones|,|Menaquinols|,NITRATE
PWY0-1573	E-,NAD,NADH,NITRITE,WATER,PROTON,|Ubiquinones|,|Ubiquinols|,NITRATE
PWY0-1578	E-,HYDROGEN-MOLECULE,TRIMETHYLAMINE,WATER,|Menaquinones|,TRIMETHYLAMINE-N-O,PROTON,|Menaquinols|
PWY0-1584	E-,DIHYDROXY-ACETONE-PHOSPHATE,GLYCEROL-3P,NITRITE,WATER,NITRATE,|Reduced-NapC-proteins|,PROTON,|Ubiquinones|,|Ubiquinols|,|Oxidized-NapC-proteins|
PROUT-PWY-I	E-,NADH,GLT,NAD,L-GLUTAMATE_GAMMA-SEMIALDEHYDE,WATER,L-DELTA1-PYRROLINE_5-CARBOXYLATE,PROTON,|Ubiquinols|,|Ubiquinones|,PRO
PWY0-1321	E-,CARBON-DIOXIDE,FORMATE,PROTON,WATER,NITRITE,|Menaquinones|,|Menaquinols|,NITRATE
PWY0-1348	E-,NAD,PROTON,NADH,DMSO,|Menaquinols|,|Menaquinones|,CPD-7670,WATER
PWY0-1356	E-,CARBON-DIOXIDE,PROTON,FORMATE,DMSO,|Menaquinols|,|Menaquinones|,CPD-7670,WATER
PWY-7335	PROTON,NADH,UDP-MANNACA,NAD,WATER,UDP-MANNAC,UDP-N-ACETYL-D-GLUCOSAMINE
PWY0-1577	E-,DMSO,CPD-7670,WATER,PROTON,|Menaquinols|,|Menaquinones|,HYDROGEN-MOLECULE
PWY0-1582	E-,PROTON,DIHYDROXY-ACETONE-PHOSPHATE,GLYCEROL-3P,SUC,|Menaquinones|,|Menaquinols|,FUM
PWY-7343	|Phosphorylated-phosphoglucomutase|,ALPHA-GLUCOSE-16-BISPHOSPHATE,|Phosphoglucomutase|,PPI,CPD-12575,PROTON,UTP,|D-glucopyranose-6-phosphate|,GLC-1-P
PWY0-1347	E-,NAD,NADH,TRIMETHYLAMINE,WATER,|Menaquinones|,TRIMETHYLAMINE-N-O,PROTON,|Menaquinols|
PWY0-1355	E-,CARBON-DIOXIDE,FORMATE,TRIMETHYLAMINE,WATER,|Menaquinones|,TRIMETHYLAMINE-N-O,PROTON,|Menaquinols|
PWY-7344	CPD-14553,CPD-12575
PWY0-1576	E-,PROTON,HYDROGEN-MOLECULE,SUC,|Menaquinones|,|Menaquinols|,FUM
PWY-7870	SO3,CYS,ACET,SULFO-CYSTEINE,PROTON,S2O3,CO-A,ACETYLSERINE,SER,ACETYL-COA,|Red-Glutaredoxins|,OXIDIZED-GLUTATHIONE,GLUTATHIONE,|Ox-Glutaredoxins|
PWY-7346	UDP-GLUCURONATE,NADH,PROTON,CPD-12575,WATER,NAD
CYSTSYN-PWY	CO-A,SER,ACETYL-COA,ACET,CYS,PROTON,ACETYLSERINE,HS
PWY0-541	PROTON,ADENOSYL-HOMO-CYS,|Phospholipid-Cyclopropane-Fatty-Acids|,S-ADENOSYLMETHIONINE,|Phospholipid-Olefinic-Fatty-Acids|
LCYSDEG-PWY	HS,CYS,2-AMINOACRYLATE,AMMONIUM,PYRUVATE,CPD-16015,WATER
PWY-7176	AMMONIUM,UMP,UDP,GLT,CTP,|Pi|,ADP,PROTON,ATP,UTP,GLN,WATER
PWY-5852	CARBON-DIOXIDE,PPI,CPD-12115,OCTAPRENYL-DIPHOSPHATE,DIHYDROXYNAPHTHOATE,PROTON
GLYOXDEG-PWY	CO-A,MAL,PROTON,ACETYL-COA,WATER,GLYOX,|Donor-H2|,|Acceptor|,GLYCOLLATE
GLYCOLATEMET-PWY	CARBON-DIOXIDE,GLYOX,|Donor-H2|,|Acceptor|,GLYCOLLATE,NADH,TARTRONATE-S-ALD,NAD,ADP,2-PG,PROTON,ATP,GLYCERATE
PWY-7187	AMMONIUM,PPI,DIHYDROFOLATE-GLU-N,METHYLENE-THF-GLU-N,DUMP,TMP,ADP,TTP,TDP,ATP,DUTP,UTP,WATER,CARBON-DIOXIDE,DCTP,FORMATE,CTP,PROTON
PWY-7222	|Red-Thioredoxin|,|Ox-Thioredoxin|,CARBON-DIOXIDE,FORMATE,GTP,PROTON,|Reduced-NrdH-Proteins|,GDP,|Oxidized-NrdH-Proteins|,WATER,ADP,DGTP,DGDP,ATP
PWY-7183	URACIL,PRPP,PPI,UMP
GLUTORN-PWY	CO-A,ACETYL-COA,ADP,ACETYL-GLU,ATP,NADPH,N-ACETYL-GLUTAMYL-P,PROTON,NADP,|Pi|,GLT,CPD-469,2-KETOGLUTARATE,ACET,L-ORNITHINE,N-ALPHA-ACETYLORNITHINE,WATER
RHAMCAT-PWY	DIHYDROXY-ACETONE-PHOSPHATE,LACTALD,ADP,RHAMNULOSE-1P,PROTON,ATP,CPD-16567,CPD-16566,CPD0-1112,RHAMNOSE
PWY0-1535	D-SERINE,2-AMINOACRYLATE,AMMONIUM,PYRUVATE,CPD-16015,WATER
PWY-7195	|D-Ribofuranose|,CYTIDINE,URACIL,AMMONIUM,PROTON,WATER,CYTOSINE
BSUBPOLYAMSYN-PWY	5-METHYLTHIOADENOSINE,SPERMIDINE,PUTRESCINE,S-ADENOSYLMETHIONINAMINE,CARBON-DIOXIDE,S-ADENOSYLMETHIONINE,PROTON
PWY-7205	CMP,ADP,CTP,CDP,ATP
NONMEVIPP-PWY	CARBON-DIOXIDE,PYRUVATE,GAP,NADPH,DEOXYXYLULOSE-5P,NADP,|Reduced-ferredoxins|,|Oxidized-ferredoxins|,PPI,2-C-METHYL-D-ERYTHRITOL-4-PHOSPHATE,CTP,ADP,4-CYTIDINE-5-DIPHOSPHO-2-C,ATP,CMP,2-PHOSPHO-4-CYTIDINE-5-DIPHOSPHO-2-C-MET,CPD-4211,DELTA3-ISOPENTENYL-PP,|Reduced-flavodoxins|,2C-METH-D-ERYTHRITOL-CYCLODIPHOSPHATE,HYDROXY-METHYL-BUTENYL-DIP,|Oxidized-flavodoxins|,WATER,PROTON
PWY0-181	AMMONIUM,WATER,DEOXYCYTIDINE,DUMP,URACIL,DEOXYURIDINE,THYMINE,DEOXY-D-RIBOSE-1-PHOSPHATE,|Pi|,ADP,TMP,PROTON,THYMIDINE,ATP
PWY-6556	AMMONIUM,PROTON,CYTIDINE,URACIL,|D-Ribofuranose|,URIDINE,WATER
PWY0-1533	ADENINE,CPD0-1068,ATP,PPI,CPD0-2479,|Acceptor|,MET,CH33ADO,CH4,S-ADENOSYLMETHIONINE,CPD0-2480,|Donor-H2|,RIBOSE-15-BISPHOSPHATE,PROTON,CPD0-2463,WATER
MENAQUINONESYN-PWY	ADENOSYL-HOMO-CYS,PROTON,REDUCED-MENAQUINONE,S-ADENOSYLMETHIONINE,CPD-12115
PWY-7194	AMMONIUM,PROTON,WATER,CYTOSINE,URACIL,PRPP,PPI,UMP
PWY-5838	FARNESYL-PP,DELTA3-ISOPENTENYL-PP,AMP,ATP,O-SUCCINYLBENZOATE,CHORISMATE,ISOCHORISMATE,2-KETOGLUTARATE,PYRUVATE,CPD-9923,CPD-9924,CPD-6972,CO-A,CPD-9925,WATER,ADENOSYL-HOMO-CYS,REDUCED-MENAQUINONE,S-ADENOSYLMETHIONINE,CARBON-DIOXIDE,PPI,CPD-12115,OCTAPRENYL-DIPHOSPHATE,DIHYDROXYNAPHTHOATE,PROTON
PWY0-1317	E-,NADH,PROTON,WATER,NAD,LACTALD,PYRUVATE,|ETR-Quinols|,|ETR-Quinones|,L-LACTATE
PHESYN	GLT,PHE,2-KETOGLUTARATE,CARBON-DIOXIDE,WATER,PHENYL-PYRUVATE,PROTON,PREPHENATE,CHORISMATE
PWY0-163	PRPP,PPI,CTP,RIBOSE-1P,|Pi|,URACIL,AMMONIUM,WATER,CYTOSINE,UMP,URIDINE,GDP,PROTON,CYTIDINE,GTP,CDP,ADP,ATP,CMP
PWY0-1315	PROTON,NADH,LACTALD,PROPANE-1-2-DIOL,NAD
PWY0-44	FRUCTOSE-6P,D-ALLULOSE-6-PHOSPHATE,ADP,D-ALLOSE-6-PHOSPHATE,PROTON,|D-Allopyranose|,ATP
PWY-7193	AMMONIUM,WATER,UMP,URIDINE,PROTON,ADP,CMP,CYTIDINE,ATP
LYXMET-PWY	L-LYXOSE,ADP,PROTON,L-XYLULOSE,ATP,L-XYLULOSE-5-P,XYLULOSE-5-PHOSPHATE,L-RIBULOSE-5-P
ETOH-ACETYLCOA-ANA-PWY	ETOH,ACETYL-COA,NADH,PROTON,NAD,CO-A,ACETALD
PWY0-1300	CPD-15979,CPD0-1063,WATER,ADP,2-PG,PROTON,ATP,GLYCERATE
PWY-7196	AMMONIUM,|D-Ribofuranose|,URIDINE,CYTIDINE,URACIL,PRPP,PPI,UMP,UDP,GLT,|Pi|,PROTON,UTP,GLN,WATER,CMP,ADP,CTP,CDP,ATP
PWY0-1314	FRUCTOSE-16-DIPHOSPHATE,ADP,PROTON,ATP,FRU1P
GLUCOSE1PMETAB-PWY	|Phosphorylated-phosphoglucomutase|,ALPHA-GLUCOSE-16-BISPHOSPHATE,|Phosphoglucomutase|,E-,|Pi|,GLUCONATE,WATER,GLC-1-P,PROTON,ADP,|D-glucopyranose-6-phosphate|,ATP,GLC-D-LACTONE,|Ubiquinols|,|Ubiquinones|,|Glucopyranose|
PWY-7208	AMMONIUM,UDP,GLT,CTP,|Pi|,ADP,PROTON,ATP,UTP,GLN,WATER,URACIL,PRPP,PPI,UMP
PWY-7180	DEOXY-D-RIBOSE-1-PHOSPHATE,GAP,DEOXY-RIBOSE-5P,ACETYL-COA,NADH,PROTON,NAD,CO-A,ACETALD
PWY0-1309	ACET,DIACETYLCHITOBIOSE-6-PHOSPHATE,GLUCOSAMINE,N-ACETYL-D-GLUCOSAMINE-6-P,CPD0-2501,WATER
PWY-5669	CMP,CDPDIACYLGLYCEROL,SER,CARBON-DIOXIDE,L-1-PHOSPHATIDYL-ETHANOLAMINE,L-1-PHOSPHATIDYL-SERINE,PROTON
RIBOKIN-PWY	PROTON,ADP,CPD-15317,|D-Ribofuranose|,ATP,CPD0-1108,CPD0-1110
THIOREDOX-PWY	PROTON,NADPH,NADP,|Acceptor|,|Red-Thioredoxin|,|Ox-Thioredoxin|,|Donor-H2|
FUCCAT-PWY	DIHYDROXY-ACETONE-PHOSPHATE,LACTALD,ADP,FUCULOSE-1P,PROTON,ATP,L-FUCULOSE,CPD0-1107,CPD-10329
MANNCAT-PWY	FRUCTOSE-6P,CPD-15979
GLUTATHIONESYN-PWY	CYS,GLT,ADP,|Pi|,GLUTATHIONE,PROTON,GLY,L-GAMMA-GLUTAMYLCYSTEINE,ATP
PWY-5971	|Hex-2-enoyl-ACPs|,|R-3-hydroxyhexanoyl-ACPs|,|3-oxo-hexanoyl-ACPs|,|Butanoyl-ACPs|,|Acetoacetyl-ACPs|,|Crotonyl-ACPs|,|Beta-3-hydroxybutyryl-ACPs|,|Hexanoyl-ACPs|,|3-Oxo-octanoyl-ACPs|,|2-Octenoyl-ACPs|,|3-Hydroxy-octanoyl-ACPs|,|Octanoyl-ACPs|,|3-oxo-decanoyl-ACPs|,|Trans-D2-decenoyl-ACPs|,|Beta-hydroxydecanoyl-ACPs|,|Decanoyl-ACPs|,|3-oxo-dodecanoyl-ACPs|,|R-3-hydroxydodecanoyl-ACPs|,|Dodec-2-enoyl-ACPs|,|Dodecanoyl-ACPs|,|3-oxo-myristoyl-ACPs|,|R-3-hydroxymyristoyl-ACPs|,|Tetradec-2-enoyl-ACPs|,ACP,CARBON-DIOXIDE,|Myristoyl-ACPs|,MALONYL-ACP,NADPH,|3-oxo-palmitoyl-ACPs|,NADP,WATER,|R-3-Hydroxypalmitoyl-ACPs|,PROTON,NADH,|2-Hexadecenoyl-ACPs|,|Palmitoyl-ACPs|,NAD
PWY0-1301	|Glucopyranose|,|D-galactopyranose|,WATER,MELIBIOSE
DARABCATK12-PWY	|D-arabinopyranose|,ADP,D-RIBULOSE,ATP,DIHYDROXY-ACETONE-PHOSPHATE,D-RIBULOSE-1-P,GLYCOLLATE,NADH,PROTON,WATER,NAD,GLYCOLALDEHYDE
GLUT-REDOX-PWY	OXIDIZED-GLUTATHIONE,GLUTATHIONE,|Ox-Glutaredoxins|,|Protein-Red-Disulfides|,|Protein-Ox-Disulfides|,|Red-Glutaredoxins|
PWY-7884	SN-GLYCEROL-1-PHOSPHATE,|Prolipoprotein-Cysteines|,L-1-PHOSPHATIDYL-GLYCEROL,PROTON,|1-Lyso-phospholipids|,|a-mature-triacylated-lipoprotein|,|Phosphoglycerides|,|Diacylglycerol-Prolipoproteins|,MONOMER0-4342,|Peptides-holder|,|Lipoprotein-signal-peptide|,WATER
PWY0-1599	|ETR-Quinols|,|ETR-Quinones|,|a--reduced-DsbB-protein|,|an-oxidized-DsbB-protein|,|Protein-Disulfides|,|a-reduced-DsbA-protein|,|an-oxidized-DsbA-protein|,|Protein-Dithiols|
GALACTCAT-PWY	ADP,PROTON,ATP,PYRUVATE,GAP,DEHYDRO-DEOXY-GALACTONATE-PHOSPHATE,2-DEHYDRO-3-DEOXY-D-GALACTONATE,WATER,D-GALACTONATE
PWY0-1600	|Ox-thioredoxins-1|,|Red-thioredoxins-1|,|Protein-Disulfides|,|a-reduced-DsbD-protein|,|an-oxidized-DsbD-protein|,|Protein-Dithiols|
PWY-7242	NADH,FRUCTURONATE,NAD,WATER,D-MANNONATE,ADP,PROTON,2-DEHYDRO-3-DEOXY-D-GLUCONATE,ATP,PYRUVATE,GAP,2-KETO-3-DEOXY-6-P-GLUCONATE
KETOGLUCONMET-PWY	CPD-2961,ADP,ATP,GLUCONATE,5-DEHYDROGLUCONATE,NADH-P-OR-NOP,NAD-P-OR-NOP,CPD-377,25-DIDEHYDRO-D-GLUCONATE,PROTON,NADPH,CPD-13059,L-IDONATE,NADP
IDNCAT-PWY	CPD-2961,ADP,ATP,GLUCONATE,PROTON,5-DEHYDROGLUCONATE,NADH-P-OR-NOP,NAD-P-OR-NOP,L-IDONATE
METSYN-PWY	CO-A,SUC-COA,CPD-1301,CPD-1302,THF-GLU-N,MET,5-METHYL-THF-GLU-N,SUC,CYS,O-SUCCINYL-L-HOMOSERINE,HOMO-CYS,L-CYSTATHIONINE,2-AMINOACRYLATE,AMMONIUM,PYRUVATE,CPD-16015,WATER,ADP,L-ASPARTATE,ATP,L-BETA-ASPARTYL-P,NADPH,NADP,|Pi|,PROTON,L-ASPARTATE-SEMIALDEHYDE,NADH-P-OR-NOP,NAD-P-OR-NOP,HOMO-SER
PWY0-1306	NADH,D-TAGATURONATE,PROTON,CPD0-1083,NAD
HOMOSER-METSYN-PWY	CO-A,HOMO-SER,SUC-COA,CPD-1301,CPD-1302,THF-GLU-N,MET,5-METHYL-THF-GLU-N,SUC,PROTON,CYS,O-SUCCINYL-L-HOMOSERINE,HOMO-CYS,L-CYSTATHIONINE,2-AMINOACRYLATE,AMMONIUM,PYRUVATE,CPD-16015,WATER
GALACTARDEG-PWY	PYRUVATE,TARTRONATE-S-ALD,NADH-P-OR-NOP,NAD-P-OR-NOP,WATER,5-KETO-4-DEOXY-D-GLUCARATE,D-GALACTARATE,ADP,2-PG,PROTON,ATP,GLYCERATE
GALACTUROCAT-PWY	WATER,ADP,2-DEHYDRO-3-DEOXY-D-GLUCONATE,ATP,NADH,PROTON,NAD,D-ALTRONATE,D-TAGATURONATE,CPD-15633,PYRUVATE,GAP,2-KETO-3-DEOXY-6-P-GLUCONATE
PWY-5188	UROPORPHYRINOGEN-III,HYDROXYMETHYLBILANE,AMMONIUM,PORPHOBILINOGEN,WATER,5-AMINO-LEVULINATE,PROTON,NADPH,GLUTAMATE-1-SEMIALDEHYDE,NADP,AMP,PPI,|Charged-GLT-tRNAs|,|GLT-tRNAs|,GLT,ATP
GLUCARDEG-PWY	PYRUVATE,TARTRONATE-S-ALD,NADH-P-OR-NOP,NAD-P-OR-NOP,WATER,5-KETO-4-DEOXY-D-GLUCARATE,D-GLUCARATE,ADP,2-PG,PROTON,ATP,GLYCERATE
GLUCUROCAT-PWY	NADH,NAD,D-MANNONATE,ADP,PROTON,2-DEHYDRO-3-DEOXY-D-GLUCONATE,ATP,PYRUVATE,GAP,2-KETO-3-DEOXY-6-P-GLUCONATE,FRUCTURONATE,|Alcohols|,WATER,|Beta-D-Glucuronides|,CPD-15530,|D-Glucopyranuronate|
PWY-7247	FRUCTURONATE,|Alcohols|,WATER,|Beta-D-Glucuronides|,CPD-15530,|D-Glucopyranuronate|
PWY-7446	DIHYDROXY-ACETONE-PHOSPHATE,NADH,CPD-18717,|2-3-dihydroxypropane-1-sulfonate|,NAD,PROTON,ADP,CPD-16502,ATP,CPD-16501,CPD-10247,GLYCEROL,CPD-21685,CPD-19111,WATER
GLUTDEG-PWY	GLT,OXALACETIC_ACID,2-KETOGLUTARATE,FUM,AMMONIUM,L-ASPARTATE
ASPARTATESYN-PWY	GLT,OXALACETIC_ACID,L-ASPARTATE,2-KETOGLUTARATE
GLYCOCAT-PWY	|Phosphorylated-phosphoglucomutase|,ALPHA-GLUCOSE-16-BISPHOSPHATE,|Phosphoglucomutase|,|Glycogens|,CPD0-971,MALTOTETRAOSE,MALTOSE,MALTOTRIOSE,WATER,CPD0-1027,|Pi|,GLC-1-P,PROTON,ADP,|D-glucopyranose-6-phosphate|,|Glucopyranose|,ATP
NADPHOS-DEPHOS-PWY	ADP,ATP,PROTON,NADH,NADPH,|Pi|,NAD,NADP,WATER
PYRIDNUCSAL-PWY	|Pi|,ADP,NICOTINATE_NUCLEOTIDE,PRPP,CPD-15317,NICOTINAMIDE_NUCLEOTIDE,GLT,NAD,PPI,AMP,PROTON,ATP,DEAMIDO-NAD,GLN,NIACINE,AMMONIUM,NIACINAMIDE,WATER
PWY3O-4106	PPI,NAD,ADP,NICOTINAMIDE_NUCLEOTIDE,PROTON,NICOTINAMIDE_RIBOSE,ATP
LEUSYN-PWY	NADH,NAD,GLT,LEU,2-KETOGLUTARATE,CO-A,3-CARBOXY-3-HYDROXY-ISOCAPROATE,2-KETO-ISOVALERATE,ACETYL-COA,CARBON-DIOXIDE,2K-4CH3-PENTANOATE,PROTON,CPD-7100,WATER,CPD-9451,2-D-THREO-HYDROXY-3-CARBOXY-ISOCAPROATE
PWY-7761	NICOTINATE_NUCLEOTIDE,AMMONIUM,NICOTINAMIDE_NUCLEOTIDE,GLT,NAD,PPI,AMP,PROTON,ATP,DEAMIDO-NAD,GLN,WATER
PYRIDNUCSYN-PWY	GLT,GLN,NAD,AMP,AMMONIUM,ATP,DEAMIDO-NAD,PRPP,NICOTINATE_NUCLEOTIDE,PPI,CARBON-DIOXIDE,|Pi|,WATER,QUINOLINATE,DIHYDROXY-ACETONE-PHOSPHATE,IMINOASPARTATE,HYDROGEN-PEROXIDE,PROTON,OXYGEN-MOLECULE,L-ASPARTATE
PWY-5453	NADPH,METHYL-GLYOXAL,NADP,PROTON,NADH,ACETOL,PROPANE-1-2-DIOL,NAD
PWY-5386	E-,METHYL-GLYOXAL,GLUTATHIONE,PROTON,S-LACTOYL-GLUTATHIONE,WATER,PYRUVATE,|Ubiquinols|,|Ubiquinones|,D-LACTATE
PWY-5459	E-,NADH,WATER,NAD,PYRUVATE,|ETR-Quinols|,|ETR-Quinones|,L-LACTATE,PROTON,NADPH,METHYL-GLYOXAL,LACTALD,NADP
P2-PWY	APO-CITRATE-LYASE,ADENINE,2-5-TRIPHOSPHORIBOSYL-3-DEPHOSPHO-,DEPHOSPHO-COA,PANTETHEINE-P,S-ACETYLPHOSPHOPANTETHEINE,AMP,PPI,ATP,PROTON,ACET,HOLO-CITRATE-LYASE,CITRATE-LYASE,WATER
PWY-5964	PPI,CPD-582,PROTON,CPD-8123,GTP
PWY0-1325	GLT,GLN,WATER,AMP,PPI,ASN,PROTON,L-ASPARTATE,AMMONIUM,ATP
PWY-6012	PANTETHEINE-P,WATER,PROTON,|All-holo-ACPs|,3-5-ADP,|All-apo-ACPs|,CO-A
ASPARAGINESYN-PWY	AMP,PPI,ASN,PROTON,L-ASPARTATE,AMMONIUM,ATP
PWY-7219	GDP,|Pi|,PROTON,L-ASPARTATE,IMP,GTP,FUM,ADENYLOSUCC,ADP,AMP,ATP
ASPARAGINE-BIOSYNTHESIS	AMMONIUM,AMP,PPI,ASN,GLT,PROTON,GLN,L-ASPARTATE,ATP,WATER
PWY-7221	AMMONIUM,NADH,NAD,IMP,AMP,PPI,GLT,PROTON,WATER,GLN,XANTHOSINE-5-PHOSPHATE,GMP,ADP,GTP,GDP,ATP
PWY-6476	PPI,CPD0-1882,PROTON,CPD-8123,CTP
PWY-6123	L-ASPARTATE,FUM,P-RIBOSYL-4-SUCCCARB-AMINOIMIDAZOLE,THF-GLU-N,FORMYL-THF-GLU-N,AICAR,PHOSPHORIBOSYL-FORMAMIDO-CARBOXAMIDE,IMP,WATER,PHOSPHORIBOSYL-CARBOXY-AMINOIMIDAZOLE,|Pi|,ADP,CPD0-181,PROTON,5-PHOSPHORIBOSYL-5-AMINOIMIDAZOLE,ATP,HCO3
PWY0-1433	NADPH,CPD0-2101,NADP,|Pi|,CPD-11770,DIHYDROMONAPTERIN-TRIPHOSPHATE,DIHYDRONEOPTERIN-P3,FORMATE,PROTON,GTP,WATER
SAM-PWY	PPI,|Pi|,S-ADENOSYLMETHIONINE,ATP,MET,WATER
PWY0-1507	CPD-5662,ADP,|Pi|,PROTON,CARBON-DIOXIDE,ATP,|Oxidized-2Fe-2S-Ferredoxins|,MET,CH33ADO,BIOTIN,|Unsulfurated-Sulfur-Acceptors|,|Sulfurated-Sulfur-Acceptors|,DETHIOBIOTIN,|Reduced-2Fe-2S-Ferredoxins|,DIAMINONONANOATE,S-ADENOSYL-4-METHYLTHIO-2-OXOBUTANOATE,S-ADENOSYLMETHIONINE,8-AMINO-7-OXONONANOATE
BIOTIN-BIOSYNTHESIS-PWY	CPD-5662,METOH,|Pimeloyl-ACP-methyl-esters|,|Enoylpimeloyl-ACP-methyl-esters|,|3-hydroxypimeloyl-ACP-methyl-esters|,|3-Ketopimeloyl-ACP-methyl-esters|,NADH,|Glutaryl-ACP-methyl-esters|,NAD,WATER,|Enoylglutaryl-ACP-methyl-esters|,NADPH,|3-Hydroxyglutaryl-ACP-methyl-ester|,NADP,ADENOSYL-HOMO-CYS,|3-Ketoglutaryl-ACP-methyl-ester|,|Malonyl-acp-methyl-ester|,MALONYL-ACP,ACP,|Pimeloyl-ACPs|,L-ALPHA-ALANINE,ADP,|Pi|,PROTON,CARBON-DIOXIDE,ATP,|Oxidized-2Fe-2S-Ferredoxins|,MET,CH33ADO,BIOTIN,|Unsulfurated-Sulfur-Acceptors|,|Sulfurated-Sulfur-Acceptors|,DETHIOBIOTIN,|Reduced-2Fe-2S-Ferredoxins|,DIAMINONONANOATE,S-ADENOSYL-4-METHYLTHIO-2-OXOBUTANOATE,S-ADENOSYLMETHIONINE,8-AMINO-7-OXONONANOATE
PWY0-1221	4-AMINO-BUTYRATE,NADH-P-OR-NOP,CPD-9000,NAD-P-OR-NOP,AMMONIUM,HYDROGEN-PEROXIDE,GAMMA-GLUTAMYL-GAMMA-AMINOBUTYRALDEH,WATER,OXYGEN-MOLECULE,|Pi|,ADP,GAMMA-GLUTAMYL-PUTRESCINE,PROTON,PUTRESCINE,GLT,ATP
PUTDEG-PWY	PROTON,NADH,4-AMINO-BUTYRATE,NAD,WATER,GLT,4-AMINO-BUTYRALDEHYDE,PUTRESCINE,2-KETOGLUTARATE
PWY0-901	WATER,SE-2,|Charged-SEC-tRNAs|,|Pi|,SEPO3,AMP,PPI,|L-seryl-SEC-tRNAs|,|tRNA-Sec|,SER,ATP
ASPARAGINE-DEG1-PWY	AMMONIUM,L-ASPARTATE,ASN,WATER
PWY-6823	CH33ADO,MET,S-ADENOSYLMETHIONINE,GTP,CPD-4,WATER,CPD-8123,CPD-8122,CPD-3,|MPT-Synthase-small-subunits|,ATP,PROTON,|Acceptor|,AMP,|Thiocarboxylated-MPT-synthases|,|Carboxyadenylated-MPT-synthases|,|Donor-H2|,L-ALPHA-ALANINE,|L-Cysteine-Desulfurase-persulfide|,|Cysteine-Desulfurase-L-cysteine|,CYS,PPI,PRECURSOR-Z,CPD-19179
PWY-6147	AMP,DIHYDROPTERIN-CH2OH-PP,ATP,AMINO-OH-HYDROXYMETHYL-DIHYDROPTERIDINE,GLYCOLALDEHYDE,|Pi|,DIHYDRO-NEO-PTERIN,PPI,DIHYDRONEOPTERIN-P,DIHYDRONEOPTERIN-P3,FORMATE,PROTON,GTP,WATER
PANTO-PWY	AMP,PPI,B-ALANINE,NADPH,L-PANTOATE,NADP,THF-GLU-N,2-DEHYDROPANTOATE,METHYLENE-THF-GLU-N,2-KETO-ISOVALERATE,WATER,ADP,4-P-PANTOTHENATE,PROTON,PANTOTHENATE,ATP
PWY-6608	AMMONIUM,GMP,PROTON,NADH,URATE,XANTHINE,NAD,WATER,GUANINE,RIBOSE-1P,GUANOSINE,|Pi|
PWY-5340	PPI,SULFATE,ADP,PAPS,PROTON,APS,ATP
PWY0-461	LYS,|Glutamates|,CADAVERINE,NADH,CPD-12763,NAD,PROTON,NADPH,NADP,WATER,CPD-280,GLT,5-AMINOPENTANOATE,CARBON-DIOXIDE,SUC,GLUTARATE,OXYGEN-MOLECULE,|ETR-Quinols|,2-KETOGLUTARATE,CPD-381,|ETR-Quinones|
HISTSYN-PWY	AMMONIUM,HIS,NADH,HISTIDINAL,NAD,|Pi|,HISTIDINOL,L-HISTIDINOL-P,2-KETOGLUTARATE,IMIDAZOLE-ACETOL-P,AICAR,D-ERYTHRO-IMIDAZOLE-GLYCEROL-P,GLT,GLN,PHOSPHORIBULOSYL-FORMIMINO-AICAR-P,PHOSPHORIBOSYL-FORMIMINO-AICAR-P,PHOSPHORIBOSYL-AMP,WATER,PRPP,ATP,PROTON,PHOSPHORIBOSYL-ATP,PPI
GLUCONEO-PWY	|D-glucopyranose-6-phosphate|,FRUCTOSE-6P,FRUCTOSE-16-DIPHOSPHATE,DPG,G3P,2-PG,ADP,OXALACETIC_ACID,AMP,PHOSPHO-ENOL-PYRUVATE,|Pi|,PROTON,WATER,ATP,NADH,NAD,PYRUVATE,CARBON-DIOXIDE,NADPH,NADP,MAL,DIHYDROXY-ACETONE-PHOSPHATE,GAP
MANNIDEG-PWY	NADH,FRUCTOSE-6P,PROTON,MANNITOL-1P,NAD
HEXITOLDEGSUPER-PWY	23-DIPHOSPHOGLYCERATE,|Protein-Histidines|,|Protein-pi-phospho-L-histidines|,CPD-16758,MANNITOL-1P,CPD-15709,D-SORBITOL-6-P,TAGATOSE-1-6-DIPHOSPHATE,CPD-15826,TAGATOSE-6-PHOSPHATE,|Hpr-Histidine|,GALACTITOL-1-PHOSPHATE,|Hpr-pi-phospho-L-histidines|,GALACTITOL,NADH,DPG,NAD,GAP,DIHYDROXY-ACETONE-PHOSPHATE,ADP,AMP,PHOSPHO-ENOL-PYRUVATE,PROTON,PYRUVATE,ATP,|Pi|,FRUCTOSE-6P,FRUCTOSE-16-DIPHOSPHATE,WATER,G3P,2-PG
PWY-5785	PPI,FARNESYL-PP,DELTA3-ISOPENTENYL-PP,|Pi|,CPD-9646,PROTON,UNDECAPRENYL-DIPHOSPHATE,WATER
GALACTITOLCAT-PWY	ADP,ATP,GAP,DIHYDROXY-ACETONE-PHOSPHATE,TAGATOSE-1-6-DIPHOSPHATE,PROTON,NADH,NAD,CPD-15826,TAGATOSE-6-PHOSPHATE,|Hpr-Histidine|,GALACTITOL-1-PHOSPHATE,|Hpr-pi-phospho-L-histidines|,GALACTITOL
PWY-5783	PPI,OCTAPRENYL-DIPHOSPHATE,FARNESYL-PP,DELTA3-ISOPENTENYL-PP
SORBDEG-PWY	PROTON,NADH,CPD-15709,D-SORBITOL-6-P,NAD
POLYISOPRENSYN-PWY	GERANYL-PP,CPD-4211,|Pi|,CPD-9646,PROTON,UNDECAPRENYL-DIPHOSPHATE,WATER,PPI,OCTAPRENYL-DIPHOSPHATE,FARNESYL-PP,DELTA3-ISOPENTENYL-PP
FAO-PWY	NADH,NAD,3-KETOACYL-COA,ACETYL-COA,D-3-HYDROXYACYL-COA,AMP,PPI,CPD66-39,CO-A,ATP,|ETF-Reduced|,|Saturated-Fatty-Acyl-CoA|,|ETF-Oxidized|,PROTON,CIS-DELTA3-ENOYL-COA,WATER,TRANS-D2-ENOYL-COA,L-3-HYDROXYACYL-COA
PWY-5123	PPI,FARNESYL-PP,GERANYL-PP,CPD-4211,DELTA3-ISOPENTENYL-PP
TRNA-CHARGING-PWY	|Charged-ARG-tRNAs|,|ARG-tRNAs|,ARG,|Charged-CYS-tRNAs|,|CYS-tRNAs|,CYS,|Charged-GLN-tRNAs|,|GLN-tRNAs|,GLN,|Charged-GLT-tRNAs|,|GLT-tRNAs|,GLT,|Charged-ILE-tRNAs|,|ILE-tRNAs|,ILE,|Charged-LEU-tRNAs|,|LEU-tRNAs|,LEU,|Charged-VAL-tRNAs|,|VAL-tRNAs|,VAL,|Charged-ALA-tRNAs|,|ALA-tRNAs|,L-ALPHA-ALANINE,|Charged-ASN-tRNAs|,|ASN-tRNAs|,ASN,|Charged-ASP-tRNAs|,|ASP-tRNAs|,L-ASPARTATE,|Charged-TYR-tRNAs|,|TYR-tRNAs|,TYR,|Charged-TRP-tRNAs|,TRP,|TRP-tRNAs|,|Charged-THR-tRNAs|,|THR-tRNAs|,THR,|Charged-SER-tRNAs|,|SER-tRNAs|,SER,|Charged-PRO-tRNAs|,|PRO-tRNAs|,PRO,|Charged-PHE-tRNAs|,|PHE-tRNAs|,PHE,|Charged-MET-tRNAs|,|Elongation-tRNAMet|,|Charged-LYS-tRNAs|,LYS,|LYS-tRNAs|,|Charged-HIS-tRNAs|,|HIS-tRNAs|,HIS,|Charged-GLY-tRNAs|,|GLY-tRNAs|,GLY,AMP,PPI,|L-methionyl-tRNAfmet|,|Initiation-tRNAmet|,MET,ATP
COA-PWY	ADP,CO-A,DEPHOSPHO-COA,ATP,CARBON-DIOXIDE,PANTETHEINE-P,R-4-PHOSPHOPANTOTHENOYL-L-CYSTEINE,CMP,PPI,PROTON,4-P-PANTOTHENATE,CYS,CTP
PWY0-1591	E-,PROTON,DIHYDROXY-ACETONE-PHOSPHATE,GLYCEROL-3P,WATER,|Menaquinones|,|Menaquinols|,HYDROGEN-PEROXIDE
PWY0-1337	CO-A,CPD0-1159,PROTON,CPD0-1158,WATER,CPD0-1162,CPD0-1163
PWY0-1590	E-,NAD,PROTON,NADH,WATER,|Menaquinones|,|Menaquinols|,HYDROGEN-PEROXIDE
PWY-7980	PROTON,|Pi|,ADP,ATP,WATER
PWY-5705	GLYOX,UREA,S-ALLANTOIN,CARBON-DIOXIDE,PROTON,ALLANTOATE,AMMONIUM,CPD-1091,CPD0-2298,WATER
PWY-5837	PPI,AMP,ATP,O-SUCCINYLBENZOATE,CHORISMATE,CARBON-DIOXIDE,ISOCHORISMATE,2-KETOGLUTARATE,PYRUVATE,CPD-9923,CPD-9924,CPD-6972,CO-A,DIHYDROXYNAPHTHOATE,PROTON,CPD-9925,WATER
PWY-5698	S-ALLANTOIN,CARBON-DIOXIDE,PROTON,ALLANTOATE,AMMONIUM,CPD-1091,CPD0-2298,WATER
PWY0-41	S-ALLANTOIN,ALLANTOATE,CPD0-2298,WATER,NADH-P-OR-NOP,NAD-P-OR-NOP,|Pi|,OXAMATE,NADH,CPD-389,CPD-1091,NAD,ADP,CARBAMOYL-P,ATP,CARBON-DIOXIDE,AMMONIUM,CARBAMATE,PROTON
ARABCAT-PWY	|L-arabinopyranose|,XYLULOSE-5-PHOSPHATE,ADP,L-RIBULOSE-5-P,PROTON,L-RIBULOSE,ATP
ARGSYN-PWY	AMMONIUM,CARBAMATE,CPD-18238,AMP,PPI,L-ASPARTATE,FUM,ARG,L-ARGININO-SUCCINATE,L-CITRULLINE,CARBAMOYL-P,GLN,HCO3,CO-A,ACETYL-COA,ADP,ACETYL-GLU,ATP,NADPH,N-ACETYL-GLUTAMYL-P,PROTON,NADP,|Pi|,GLT,CPD-469,2-KETOGLUTARATE,ACET,L-ORNITHINE,N-ALPHA-ACETYLORNITHINE,WATER
SALVPURINE2-PWY	PRPP,XANTHOSINE-5-PHOSPHATE,PPI,XANTHINE,RIBOSE-1P,XANTHOSINE,|Pi|
PPGPPMET-PWY	|Pi|,GUANOSINE-5DP-3DP,AMP,PPI,PROTON,GDP-TP,WATER,ADP,GTP,GDP,ATP
PWY-6605	PRPP,PPI,AMP,ADENINE,|D-Ribofuranose|,ADENOSINE,WATER
PWY-6611	ADENINE,RIBOSE-1P,|Pi|,AMMONIUM,WATER,ADENOSINE,ADP,IMP,PROTON,INOSINE,ATP
PROPIONMET-PWY	SUC-COA,METHYL-MALONYL-COA,D-METHYL-MALONYL-COA,|Pi|,ADP,PROTON,ATP,HCO3,PROPIONYL-COA
PWY-6609	ADENINE,RIBOSE-1P,|Pi|,INOSINE,AMMONIUM,PROTON,WATER,ADENOSINE,HYPOXANTHINE,PRPP,PPI,IMP
PWY0-42	AMP,PPI,PROPIONATE,ATP,CO-A,PROTON,OXALACETIC_ACID,PROPIONYL-COA,CPD-622,WATER,CPD-1136,PYRUVATE,SUC,CPD-618
GLYCLEAV-PWY	NADH,NAD,CARBON-DIOXIDE,GLY,PROTEIN-LIPOYLLYSINE,PROTON,AMMONIUM,METHYLENE-THF-GLU-N,DIHYDROLIPOYL-GCVH,AMINOMETHYLDIHYDROLIPOYL-GCVH,THF-GLU-N
PWY0-1391	ADENINE,CPD-560,5-METHYLTHIOADENOSINE,WATER
PWY-66	WATER,GDP-MANNOSE,GDP-4-DEHYDRO-6-DEOXY-D-MANNOSE,PROTON,NADPH,GDP-4-DEHYDRO-6-L-DEOXYGALACTOSE,CPD-13118,NADP
DAPLYSINESYN-PWY	CARBON-DIOXIDE,LYS,MESO-DIAMINOPIMELATE,SUC,LL-DIAMINOPIMELATE,GLT,2-KETOGLUTARATE,N-SUCCINYLLL-2-6-DIAMINOPIMELATE,CO-A,N-SUCCINYL-2-AMINO-6-KETOPIMELATE,SUC-COA,PYRUVATE,NADPH,NADP,|Pi|,L-ASPARTATE-SEMIALDEHYDE,ADP,L-BETA-ASPARTYL-P,L-ASPARTATE,ATP,PROTON,NADH-P-OR-NOP,CPD-14443,DELTA1-PIPERIDEINE-2-6-DICARBOXYLATE,NAD-P-OR-NOP,WATER
PWY-5659	|D-glucopyranose-6-phosphate|,FRUCTOSE-6P,CPD-15979,PPI,GDP-MANNOSE,PROTON,MANNOSE-1P,GTP
PEPTIDOGLYCANSYN-PWY	UDP,C6,UMP,C5,CPD-9646,UDP-N-ACETYL-D-GLUCOSAMINE,PHOSPHO-ENOL-PYRUVATE,UDP-ACETYL-CARBOXYVINYL-GLUCOSAMINE,NADPH,NADP,C1,L-ALPHA-ALANINE,UDP-N-ACETYLMURAMATE,CPD0-1456,D-GLT,GLT,UDP-AAGM-DIAMINOHEPTANEDIOATE,MESO-DIAMINOPIMELATE,UDP-AA-GLUTAMATE,ADP,|Pi|,D-ALA-D-ALA,PROTON,D-ALANINE,ATP
PWY0-1586	C6,CPD-17931,WATER,D-ALANINE,GLY,CPD-17985,CPD-17927,CPD-17987,CPD-17968,CPD0-2579,CPD-17932,CPD-17988,CPD-17947,CPD-17986,CPD-17926,UNDECAPRENYL-DIPHOSPHATE,PROTON,CPD-18809,CPD-17969
PWY-6700	NADPH,7-CYANO-7-DEAZAGUANINE,NADP,GUANINE,|Guanine34-in-tRNAs|,7-AMINOMETHYL-7-DEAZAGUANINE,PROTON,MET,ADENINE,S-ADENOSYLMETHIONINE,|tRNA-with-7-aminomethyl-7-deazaguanine|,|Donor-H2|,|tRNAs-containing-epoxy-quenosine|,|tRNAs-with-queuine|,|Acceptor|,WATER
PWY0-1554	PROTON,ADENOSYL-HOMO-CYS,|5-oxyacetylU34-tRNA|,5-HYDROXYU34-TRNA,WATER,CPD-15403,PHENYL-PYRUVATE,S-ADENOSYLMETHIONINE,PREPHENATE
THISYN-PWY	CARBON-MONOXIDE,FORMATE,AMINO-HYDROXYMETHYL-METHYL-PYR-P,5-PHOSPHORIBOSYL-5-AMINOIMIDAZOLE,ADP,THIAMINE-PYROPHOSPHATE,THIAMINE-P,AMINO-HYDROXYMETHYL-METHYLPYRIMIDINE-PP,WATER,CPD-13575,DEOXYXYLULOSE-5P,CARBON-DIOXIDE,PYRUVATE,GAP,|Oxidized-ferredoxins|,AMP,|Thiocarboxyadenylated-ThiS-Proteins|,|Reduced-ferredoxins|,PPI,|Adenylated-ThiS-Proteins|,|Thi-S|,ATP,PROTON,NADP,MET,CH33ADO,CPD-108,CPD-12279,S-ADENOSYLMETHIONINE,TYR,NADPH,|Sulfurylated-ThiI|,|Sulfur-Carrier-Proteins-ThiI|,L-ALPHA-ALANINE,|L-Cysteine-Desulfurase-persulfide|,|Cysteine-Desulfurase-L-cysteine|,CYS
PWY0-1479	CPD0-2351,|Nucleoside-Monophosphates|,|tRNAs|,|tRNA-fragment|,CPD0-2353,|Ribonucleoside-Monophosphates|,|Ribonucleoside-Diphosphates|,CPD0-2354,|Pi|,CPD0-2350,CPD0-2352,WATER
PWY-6890	ADP,AMINO-HYDROXYMETHYL-METHYLPYRIMIDINE-PP,ATP,PROTON,CARBON-MONOXIDE,FORMATE,MET,CH33ADO,AMINO-HYDROXYMETHYL-METHYL-PYR-P,S-ADENOSYLMETHIONINE,5-PHOSPHORIBOSYL-5-AMINOIMIDAZOLE
PWY-7892	FADH2,GLYOX,FAD,|tRNA-Containing-5MeAminoMe-2-ThioU|,ADENOSYL-HOMO-CYS,S-ADENOSYLMETHIONINE,|tRNA-Containing-5AminoMe-2-ThioUrdines|,PPI,AMP,|tRNA-uridine34|,ATP,L-ALPHA-ALANINE,CYS,|Cysteine-Desulfurase-L-cysteine|,|L-Cysteine-Desulfurase-persulfide|,|TusE-S-sulfanylcysteine|,|TusE-L-cysteine|,|TusD-Persulfides|,|TusA-L-cysteine|,|TusA-Persulfides|,|TusD-L-cysteine|,|Donor-H2|,PROTON,DIHYDROFOLATE-GLU-N,|Pi|,GDP,|tRNA-containing-5-CarbMeAminome-2-ThioU|,|tRNA-2-thiouridine34|,GTP,METHYLENE-THF-GLU-N,GLY,WATER,|Acceptor|
PWY-6618	ADP,GMP,PROTON,GUANOSINE,ATP
PWY0-1587	AMP,|N6-L-threonylcarbamoyladenine37-tRNAs|,|tRNA-adenine-37|,WATER,PPI,CPD-15435,THR,HCO3,ATP
PWY-6579	PRPP,PPI,GUANINE,RIBOSE-1P,|Pi|,ADP,GMP,PROTON,GUANOSINE,ATP
PWY0-1324	N-ACETYL-D-GLUCOSAMINE-6-P,PYRUVATE,N-ACETYLNEURAMINATE,ADP,N-ACETYL-D-MANNOSAMINE-6P,PROTON,|N-acetyl-D-mannosamine|,ATP
PWY-6620	PRPP,GMP,PPI,GUANINE,RIBOSE-1P,GUANOSINE,|Pi|
CYANCAT-PWY	AMMONIUM,WATER,CARBON-DIOXIDE,CARBAMATE,CPD-69,HCO3,PROTON
ARG+POLYAMINE-SYN	AMMONIUM,CARBAMATE,CPD-18238,UREA,AGMATHINE,SPERMIDINE,PUTRESCINE,S-ADENOSYLMETHIONINE,5-METHYLTHIOADENOSINE,CPD0-1065,S-ADENOSYLMETHIONINAMINE,CADAVERINE,CARBON-DIOXIDE,LYS,AMP,PPI,L-ASPARTATE,FUM,ARG,L-ARGININO-SUCCINATE,L-CITRULLINE,CARBAMOYL-P,GLN,HCO3,CO-A,ACETYL-COA,ADP,ACETYL-GLU,ATP,NADPH,N-ACETYL-GLUTAMYL-P,PROTON,NADP,|Pi|,GLT,CPD-469,2-KETOGLUTARATE,ACET,L-ORNITHINE,N-ALPHA-ACETYLORNITHINE,WATER
PWY0-1601	CADAVERINE,CARBON-DIOXIDE,PROTON,LYS
PWY0-1303	5-METHYLTHIOADENOSINE,CPD0-1065,S-ADENOSYLMETHIONINAMINE,CADAVERINE,CARBON-DIOXIDE,PROTON,LYS
PWY0-1305	4-AMINO-BUTYRATE,CARBON-DIOXIDE,PROTON,GLT
PWY-4121	|Pi|,ADP,GLUTATHIONYLSPERMIDINE,PROTON,SPERMIDINE,GLUTATHIONE,ATP
PWY0-1299	AGMATHINE,CARBON-DIOXIDE,PROTON,ARG
POLYAMSYN-PWY	ARG,UREA,WATER,AGMATHINE,L-ORNITHINE,SPERMIDINE,PUTRESCINE,S-ADENOSYLMETHIONINE,5-METHYLTHIOADENOSINE,CPD0-1065,S-ADENOSYLMETHIONINAMINE,CADAVERINE,CARBON-DIOXIDE,PROTON,LYS
PWY0-1501	MONOMER0-1,EG11140-MONOMER,MONOMER0-4299,PHOSPHO-BARA-ASP,ADP,MONOMER0-4210,BARA-MONOMER,ATP
BETSYN-PWY	|Donor-H2|,CHOLINE,|Acceptor|,NADH,BETAINE,PROTON,BETAINE_ALDEHYDE,NAD,WATER
PWY0-1481	PHOSPHO-BAER,BAER-MONOMER,ADP,PHOSPHO-BAES,BAES-MONOMER,ATP
PWY0-1468	CPLX0-7721,DCUR-MONOMER,ADP,PHOSPHO-DCUS-MONOMER,DCUS-MONOMER,ATP
PWY0-301	CARBON-DIOXIDE,L-XYLULOSE-5-P,PROTON,XYLULOSE-5-PHOSPHATE,L-RIBULOSE-5-P,CPD-2343,L-ASCORBATE-6-PHOSPHATE,WATER
PWY-6126	GDP,|Pi|,L-ASPARTATE,IMP,GTP,FUM,ADENYLOSUCC,AMP,|Red-Thioredoxin|,|Ox-Thioredoxin|,|Reduced-NrdH-Proteins|,|Oxidized-NrdH-Proteins|,ADP,DADP,WATER,DATP,CARBON-DIOXIDE,FORMATE,ATP,PROTON
PWY0-1506	PHOSPHO-TORR,TORR-CPLX,CPLX0-8265,ADP,ATP,TORS-CPLX,CPLX0-8268,CPLX0-8267
PWY-6125	AMMONIUM,NADH,NAD,IMP,AMP,PPI,GLT,GLN,XANTHOSINE-5-PHOSPHATE,GMP,|Red-Thioredoxin|,|Ox-Thioredoxin|,CARBON-DIOXIDE,FORMATE,GTP,PROTON,|Reduced-NrdH-Proteins|,GDP,|Oxidized-NrdH-Proteins|,WATER,ADP,DGTP,DGDP,ATP
PWY-6961	CPD-318,ASCORBATE,HYDROGEN-PEROXIDE,CPD-13907,L-DEHYDRO-ASCORBATE,WATER,ADP,ATP,NADH,CPD-334,3-KETO-L-GULONATE,NAD,CARBON-DIOXIDE,PROTON,CPD-2343,L-XYLULOSE-5-P,XYLULOSE-5-PHOSPHATE,L-RIBULOSE-5-P
DENOVOPURINE2-PWY	AMMONIUM,PRPP,5-P-BETA-D-RIBOSYL-AMINE,GLY,5-PHOSPHORIBOSYL-N-FORMYLGLYCINEAMIDINE,5-P-RIBOSYL-N-FORMYLGLYCINEAMIDE,5-PHOSPHO-RIBOSYL-GLYCINEAMIDE,P-RIBOSYL-4-SUCCCARB-AMINOIMIDAZOLE,THF-GLU-N,FORMYL-THF-GLU-N,AICAR,PHOSPHORIBOSYL-FORMAMIDO-CARBOXAMIDE,PHOSPHORIBOSYL-CARBOXY-AMINOIMIDAZOLE,CPD0-181,5-PHOSPHORIBOSYL-5-AMINOIMIDAZOLE,HCO3,NADH,NAD,PPI,GLT,GLN,XANTHOSINE-5-PHOSPHATE,GMP,DGTP,DGDP,GDP,|Pi|,L-ASPARTATE,IMP,GTP,FUM,ADENYLOSUCC,AMP,|Red-Thioredoxin|,|Ox-Thioredoxin|,|Reduced-NrdH-Proteins|,|Oxidized-NrdH-Proteins|,ADP,DADP,WATER,DATP,CARBON-DIOXIDE,FORMATE,ATP,PROTON
PWY0-1485	CPLX0-7748,CPXR-MONOMER,ADP,PHOSPHO-CPXA,ATP,CPLX0-8270
PWY0-43	CARBON-DIOXIDE,PROTON,METHYL-MALONYL-COA,SUC-COA,PROPIONATE,PROPIONYL-COA,SUC
PWY0-1514	ADP,ATP,PHOSPHO-NARP,NARP-MONOMER,NARQ-CPLX,PHOSPHO-NARL,PHOSPHO-NARQ,NARL-MONOMER
PWY-7220	|Red-Thioredoxin|,|Ox-Thioredoxin|,|Reduced-NrdH-Proteins|,|Oxidized-NrdH-Proteins|,ADP,DADP,WATER,DATP,CARBON-DIOXIDE,FORMATE,ATP,PROTON
PWY0-1492	CPLX0-7754,UHPA-MONOMER,ADP,PHOSPHO-UHPB,UHPB-MONOMER,ATP
PWY0-1519	PHOSPHO-CHEY,CHEY-MONOMER,CPLX0-8274,ADP,ATP,CHEA-CPLX
PWY0-1497	ADP,ATP,RSTB-MONOMER,PHOSPHO-RSTA,RSTA-MONOMER,PHOSPHO-RSTB
PWY0-1458	ADP,ATP,CPLX0-8168,PHOSPHO-PHOP,PHOP-MONOMER,PHOSPHO-PHOQ
PWY-6387	UDP-N-ACETYL-D-GLUCOSAMINE,PHOSPHO-ENOL-PYRUVATE,UDP-ACETYL-CARBOXYVINYL-GLUCOSAMINE,NADPH,NADP,C1,L-ALPHA-ALANINE,UDP-N-ACETYLMURAMATE,CPD0-1456,D-GLT,GLT,UDP-AAGM-DIAMINOHEPTANEDIOATE,MESO-DIAMINOPIMELATE,UDP-AA-GLUTAMATE,ADP,|Pi|,D-ALA-D-ALA,PROTON,D-ALANINE,ATP
PWY0-1500	ADP,ATP,PHOSPHO-OMPR,ENVZ-CPLX,OMPR-MONOMER,PHOSPHO-ENVZ
BRANCHED-CHAIN-AA-SYN-PWY	NADH,NAD,LEU,CO-A,3-CARBOXY-3-HYDROXY-ISOCAPROATE,ACETYL-COA,2K-4CH3-PENTANOATE,CPD-7100,CPD-9451,2-D-THREO-HYDROXY-3-CARBOXY-ISOCAPROATE,2-KETO-ISOVALERATE,VAL,CPD-13357,2-ACETO-LACTATE,GLT,2-KETO-3-METHYL-VALERATE,ILE,2-KETOGLUTARATE,NADPH,1-KETO-2-METHYLVALERATE,NADP,CARBON-DIOXIDE,2-ACETO-2-HYDROXY-BUTYRATE,PYRUVATE,THR,AMMONIUM,2-OXOBUTANOATE,PROTON,WATER,CPD-16013,CPD-15056
PWY0-1588	MONOMER0-4341,G7057-MONOMER,ADP,MONOMER0-4374,G7056-MONOMER,ATP
SER-GLYSYN-PWY	GLT,2-KETOGLUTARATE,NADH,3-P-HYDROXYPYRUVATE,PROTON,G3P,NAD,|Pi|,3-P-SERINE,WATER,METHYLENE-THF-GLU-N,GLY,SER,THF-GLU-N
ASPASN-PWY	GLT,OXALACETIC_ACID,2-KETOGLUTARATE,FUM,AMP,PPI,PROTON,ATP,AMMONIUM,L-ASPARTATE,ASN,WATER
PWY0-1297	HYPOXANTHINE,GUANINE,DEOXYGUANOSINE,ADENINE,|Pi|,DEOXYINOSINE,AMMONIUM,WATER,DEOXYADENOSINE,DEOXY-D-RIBOSE-1-PHOSPHATE,GAP,DEOXY-RIBOSE-5P,ACETYL-COA,NADH,PROTON,NAD,CO-A,ACETALD
ENTBACSYN-PWY	CHORISMATE,PYRUVATE,WATER,ISOCHORISMATE,NADH,NAD,DIHYDRO-DIOH-BENZOATE,|Apo-EntB|,2-3-DIHYDROXYBENZOATE,CPD-62,PPI,SER,ATP,3-5-ADP,|Apo-EntF|,CO-A,AMP,SERYL-AMP,PROTON,|Holo-EntB|,|23DHB-EntB|,|Seryl-EntF|,|Holo-EntF|,ENTEROBACTIN,|DHB-Seryl-EntF|
P4-PWY	L-BETA-ASPARTYL-P,NADPH,NADP,ADP,ATP,THR,|Pi|,O-PHOSPHO-L-HOMOSERINE,OXALACETIC_ACID,L-ASPARTATE,CARBON-DIOXIDE,LYS,MESO-DIAMINOPIMELATE,LL-DIAMINOPIMELATE,GLT,2-KETOGLUTARATE,N-SUCCINYLLL-2-6-DIAMINOPIMELATE,N-SUCCINYL-2-AMINO-6-KETOPIMELATE,L-ASPARTATE-SEMIALDEHYDE,NADH-P-OR-NOP,CPD-14443,DELTA1-PIPERIDEINE-2-6-DICARBOXYLATE,NAD-P-OR-NOP,CO-A,HOMO-SER,SUC-COA,CPD-1301,CPD-1302,THF-GLU-N,MET,5-METHYL-THF-GLU-N,SUC,PROTON,CYS,O-SUCCINYL-L-HOMOSERINE,HOMO-CYS,L-CYSTATHIONINE,2-AMINOACRYLATE,AMMONIUM,PYRUVATE,CPD-16015,WATER
COMPLETE-ARO-PWY	3-DEOXY-D-ARABINO-HEPTULOSONATE-7-P,ERYTHROSE-4P,|Pi|,3-ENOLPYRUVYL-SHIKIMATE-5P,PHOSPHO-ENOL-PYRUVATE,ADP,SHIKIMATE-5P,ATP,NADPH,NADP,SHIKIMATE,3-DEHYDRO-SHIKIMATE,DEHYDROQUINATE,CARBOXYPHENYLAMINO-DEOXYRIBULOSE-P,PRPP,N-5-PHOSPHORIBOSYL-ANTHRANILATE,PPI,PYRUVATE,ANTHRANILATE,GLN,GAP,INDOLE-3-GLYCEROL-P,TRP,INDOLE,SER,PHE,WATER,PHENYL-PYRUVATE,PROTON,CHORISMATE,GLT,TYR,2-KETOGLUTARATE,NADH,CARBON-DIOXIDE,P-HYDROXY-PHENYLPYRUVATE,PREPHENATE,NAD
PANTOSYN-PWY	AMP,NADPH,L-PANTOATE,NADP,THF-GLU-N,2-DEHYDROPANTOATE,METHYLENE-THF-GLU-N,2-KETO-ISOVALERATE,WATER,PANTOTHENATE,ADP,CO-A,DEPHOSPHO-COA,ATP,PANTETHEINE-P,R-4-PHOSPHOPANTOTHENOYL-L-CYSTEINE,CMP,PPI,4-P-PANTOTHENATE,CYS,CTP,CARBON-DIOXIDE,B-ALANINE,PROTON,L-ASPARTATE
PWY0-1505	ADP,ATP,ARCB-MONOMER,PHOSPHO-ARCA,ARCA-MONOMER,PHOSPHO-ARCB717,PHOSPHO-ARCB-ASP,PHOSPHO-ARCB-HIS
PWY0-1474	PHOSPHO-ATOC,ATOC-MONOMER,ADP,PHOSPHO-ATOS,ATOS-MONOMER,ATP
PWY0-1483	ADP,ATP,PHOSPHO-PHOB,PHOR-MONOMER,PHOB-MONOMER,PHOSPHO-PHOR
PWY-7179	HYPOXANTHINE,GUANINE,DEOXYGUANOSINE,DEOXY-D-RIBOSE-1-PHOSPHATE,ADENINE,|Pi|,DEOXYINOSINE,AMMONIUM,PROTON,WATER,DEOXYADENOSINE
PWY-6019	WATER,CPD-15317,URACIL,ADP,PSEUDOURIDINE-5-P,PROTON,CPD-497,ATP
PWY-2161	WATER,GLY,SER,THF-GLU-N,METHYLENE-THF-GLU-N,|Pi|,ADP,FORMYL-THF-GLU-N,GLT,ATP
PWY0-1512	ADP,ATP,CPLX0-8288,MONOMER0-4180,MONOMER0-4178,G6319-MONOMER
PWY-6614	PPI,P-AMINO-BENZOATE,DIHYDROPTERIN-CH2OH-PP,ADP,|Pi|,DIHYDROFOLATE,GLT,7-8-DIHYDROPTEROATE,ATP,PROTON,NADPH,DIHYDROFOLATE-GLU-N,THF-GLU-N,NADP
PWY-7184	DCTP,PPI,DUTP,DIHYDROFOLATE-GLU-N,METHYLENE-THF-GLU-N,DUMP,TMP,ADP,TTP,TDP,ATP,UDP,DUDP,|Red-Thioredoxin|,DCDP,|Ox-Thioredoxin|,CDP,|Pi|,PROTON,WATER,CTP
1CMET2-PWY	PROTEIN-LIPOYLLYSINE,AMINOMETHYLDIHYDROLIPOYL-GCVH,DIHYDROLIPOYL-GCVH,|Pi|,ADP,|N5-Formyl-THF-Glu-N|,ATP,MET,HOMO-CYS,5-METHYL-THF-GLU-N,NADH,CARBON-DIOXIDE,AMMONIUM,NAD,PROTON,FORMYL-THF-GLU-N,NADPH,5-10-METHENYL-THF-GLU-N,NADP,WATER,GLY,SER,THF-GLU-N,DIHYDROFOLATE-GLU-N,TMP,METHYLENE-THF-GLU-N,DUMP
PWY-7801	|L-leucyl-L-arginyl-Protein|,|Protein-N-terminal-L-Arginine|,PROTON,|LEU-tRNAs|,|L-leucyl-L-lysyl-Protein|,|Charged-LEU-tRNAs|,|Protein-N-terminal-L-Lysine|
PWY-6612	ADP,DIHYDROFOLATE,7-8-DIHYDROPTEROATE,NADPH,DIHYDROFOLATE-GLU-N,THF-GLU-N,NADP,AMP,DIHYDROPTERIN-CH2OH-PP,ATP,AMINO-OH-HYDROXYMETHYL-DIHYDROPTERIDINE,GLYCOLALDEHYDE,|Pi|,DIHYDRO-NEO-PTERIN,PPI,DIHYDRONEOPTERIN-P,DIHYDRONEOPTERIN-P3,FORMATE,GTP,WATER,GLT,GLN,CHORISMATE,PYRUVATE,P-AMINO-BENZOATE,PROTON,4-AMINO-4-DEOXYCHORISMATE
PWY-7206	DCMP,DCTP,DUMP,DUTP,PROTON,PPI,CPD-15158,5-HYDROXY-CTP,WATER
PWY-6543	GLT,GLN,CHORISMATE,PYRUVATE,P-AMINO-BENZOATE,PROTON,4-AMINO-4-DEOXYCHORISMATE
PWY-7197	TMP,DCMP,TTP,TDP,ADP,DCTP,DCDP,ATP
PWY0-1518	PHOSPHO-CHEY,CHEY-MONOMER,PHOSPHO-CHEB,CHEB-MONOMER,CPLX0-8274,ADP,ATP,CHEA-CPLX
PWY0-1490	MONOMER0-4185,ADP,MONOMER0-4184,ATP,PHOSPHO-EVGA,EVGS-MONOMER,EVGA-MONOMER,PHOSPHO-EVGS
PWY-6282	|Trans-D3-cis-D9-hexadecenoyl-ACPs|,|3-hydroxy-cis-D9-hexaecenoyl-ACPs|,|3-oxo-cis-D9-hexadecenoyl-ACPs|,NADH,|Cis-Delta7-tetradecenoyl-ACPs|,NAD,|Trans-D2-cis-D7-tetradecenoyl-ACPs|,NADPH,|3-hydroxy-cis-D7-tetraecenoyl-ACPs|,NADP,CARBON-DIOXIDE,|3-oxo-cis-D7-tetradecenoyl-ACPs|,|Cis-Delta5-dodecenoyl-ACPs|,MALONYL-ACP,PROTON,ACP,CPD-9245,|Palmitoleoyl-ACPs|,WATER
PWY0-1495	CPLX0-7795,KDPE-MONOMER,ADP,PHOSPHO-KDPD,ATP,KDPD-MONOMER
PWY0-1296	XANTHINE,XANTHOSINE,ADENINE,AMMONIUM,PROTON,WATER,ADENOSINE,HYPOXANTHINE,INOSINE,GUANINE,GUANOSINE,|Pi|,RIBOSE-5P,RIBOSE-1P
PWY-6617	ADENINE,CPD-15317,WATER,AMP
GLNSYN-PWY	|Pi|,ADP,GLN,PROTON,AMMONIUM,GLT,ATP
NRI-PWY	GLNG-CPLX,WATER,PROTEIN-NRIP,PROTEIN-NRIIP,PROTEIN-NRII,PROTEIN-PII,URIDYLYL-PII,URIDYLYL-PROTEIN-PII,|Gln-B|,|Glutamine-synthetase-Tyr|,|Glutamine-synthetase-adenylyl-Tyr|,|Pi|,ADP,GLN,PROTON,AMMONIUM,GLT,ATP,UMP,URIDYLYL-PII2,PPI,PROTEIN-PII2,UTP
AMMASSIM-PWY	WATER,|Pi|,ADP,AMMONIUM,ATP,NADPH,2-KETOGLUTARATE,GLN,PROTON,GLT,NADP
PWY0-321	SUC-COA,NADH,3-KETO-ADIPYL-COA,NAD,OXYGEN-MOLECULE,ACETYL-COA,CPD0-2362,CPD0-2363,PROTON,NADPH,CPD0-2364,CPDMETA-13650,NADP,AMP,PPI,CPD-207,CO-A,PHENYLACETATE,ATP,WATER,TRANS-23-DEHYDROADIPYL-COA,3-HYDROXYADIPYL-COA
